ϣⲉⲛⲟⲩⲧⲉ	person	person/M
ϩⲁⲙⲱⲥ	person	person/M
ϩⲉⲣⲙⲟⲅⲉⲛⲏⲥ	person	person/M
ϩⲏⲗⲉⲓⲁⲥ	person	person/M
ϩⲏⲗⲓⲁⲥ	person	person/M
ϩⲏⲣⲱⲇⲏⲥ	person	person/M
ϩⲏⲣⲱⲇⲓⲁⲥ	person	person/M
ϩⲣⲁⲁⲃ	person	person/F
ϩⲣⲁⲭⲏⲗ	person	person/F
ϩⲣⲉⲃⲉⲕⲕⲁ	person	person/F
ϩⲣⲟⲃⲟⲁⲙ	person	person/M
ϩⲣⲟⲩⲫⲟⲥ	person	person/M
ϩⲩⲙⲉⲛⲁⲓⲟⲥ	person	person/M
ϩⲩⲡⲉⲣⲉⲭⲓⲟⲥ	person	person/M
ⲁⲁⲣⲱⲛ	person	person/M
ⲁⲃⲉⲗ	person	person/M
ⲁⲃⲓⲁ	person	person/M
ⲁⲃⲓⲁⲑⲁⲣ	person	person/M
ⲁⲃⲓⲟⲩⲇ	person	person/M
ⲁⲃⲣⲁϩⲁⲙ	person	person/M
ⲁⲅⲟⲩⲥⲧⲟⲥ	person	person/M
ⲁⲅⲣⲓⲡⲡⲁⲥ	person	person/M
ⲁⲇⲁⲙ	person	person/M
ⲁⲍⲱⲣⲁ	person	person/M
ⲁⲍⲱⲣⲁⲥ	person	person/M
ⲁⲕⲩⲗⲁⲥ	person	person/M
ⲁⲗⲉⲝⲁⲛⲇⲣⲟⲥ	person	person/M
ⲁⲗⲫⲁⲓⲟⲥ	person	person/M
ⲁⲙⲓⲛⲁⲇⲁⲃ	person	person/M
ⲁⲙⲱⲛⲁ	person	person/M
ⲁⲛⲁⲛⲓⲁⲥ	person	person/M
ⲁⲛⲇⲣⲉⲁⲥ	person	person/M
ⲁⲛⲛⲁ	person	person/F
ⲁⲛⲛⲁⲥ	person	person/M
ⲁⲛⲧⲱⲛⲓⲟⲥ	person	person/M
ⲁⲡⲟⲗⲗⲱ	person	person/M
ⲁⲡⲡⲓⲟⲥ	person	person/M
ⲁⲣⲁⲙ	person	person/M
ⲁⲣⲉⲧⲁ	person	person/M
ⲁⲣⲓⲥⲧⲁⲣⲭⲟⲥ	person	person/M
ⲁⲣⲭⲏⲗⲁⲟⲥ	person	person/M
ⲁⲥⲁⲫ	person	person/M
ⲁⲫⲑⲟⲛⲓⲁ	person	person/F
ⲁⲭⲉⲓⲙ	person	person/M
ⲃⲁⲗⲁϩⲁⲙ	person	person/M
ⲃⲁⲗⲗⲁ	person	person/F
ⲃⲁⲣⲁⲃⲃⲁⲥ	person	person/M
ⲃⲁⲣⲁⲭⲓⲁⲥ	person	person/M
ⲃⲁⲣⲑⲟⲗⲟⲙⲁⲓⲟⲥ	person	person/M
ⲃⲁⲣⲛⲁⲃⲁⲥ	person	person/M
ⲃⲁⲣⲥⲁⲃⲁⲥ	person	person/M
ⲃⲁⲣⲧⲓⲙⲁⲓⲟⲥ	person	person/M
ⲃⲁⲥⲓⲙⲟⲥ	person	person/M
ⲃⲉⲉⲗⲍⲉⲃⲟⲩⲗ	person	person/M
ⲃⲏⲥⲁⲣⲓⲟⲛ	person	person/M
ⲃⲟⲉⲥ	person	person/M
ⲅⲁⲃⲣⲓⲏⲗ	person	person/M
ⲅⲁⲓⲟⲥ	person	person/M
ⲅⲁⲗⲗⲓⲱⲛ	person	person/M
ⲅⲁⲙⲁⲗⲓⲏⲗ	person	person/M
ⲅⲉⲇⲉⲱⲛ	person	person/M
ⲇⲁⲛⲓⲏⲗ	person	person/M
ⲇⲁⲩⲉⲓⲇ	person	person/M
ⲇⲉⲃⲃⲱⲣⲁ	person	person/F
ⲇⲏⲙⲁⲥ	person	person/M
ⲇⲓⲁⲃⲟⲗⲟⲥ	person	person/M
ⲇⲓⲇⲩⲙⲟⲥ	person	person/M
ⲇⲓⲙⲏⲧⲣⲓⲟⲥ	person	person/M
ⲇⲓⲟⲛⲏⲥⲓⲟⲥ	person	person/M
ⲇⲓⲟⲥⲕⲟⲣⲟⲥ	person	person/M
ⲇⲟⲣⲕⲁⲥ	person	person/F
ⲇⲟⲩⲗⲟⲥ	person	person/M
ⲉⲍⲉⲕⲉⲓⲁⲥ	person	person/M
ⲉⲓⲉⲍⲁⲃⲉⲗ	person	person/F
ⲉⲓⲟⲩⲥⲧⲟⲥ	person	person/M
ⲉⲗⲉⲁⲍⲁⲣ	person	person/M
ⲉⲗⲓⲁⲕⲓⲙ	person	person/M
ⲉⲗⲓⲟⲩⲇ	person	person/M
ⲉⲗⲓⲥⲁⲃⲉⲧ	person	person/F
ⲉⲗⲓⲥⲥⲁⲓⲟⲥ	person	person/M
ⲉⲗⲩⲙⲁⲥ	person	person/M
ⲉⲛⲁⲓⲁ	person	person/M
ⲉⲛⲱⲭ	person	person/M
ⲉⲡⲁⲫⲣⲁⲥ	person	person/M
ⲉⲣⲁⲥⲧⲟⲥ	person	person/M
ⲉⲥⲣⲱⲙ	person	person/M
ⲍⲁⲃⲟⲩⲗⲟⲛ	person	person/M
ⲍⲁⲕⲭⲁⲓⲟⲥ	person	person/M
ⲍⲁⲗⲉϩ	person	person/M
ⲍⲁⲣⲁ	person	person/M
ⲍⲁⲭⲁⲣⲓⲁⲥ	person	person/M
ⲍⲉⲃⲉⲇⲁⲓⲟⲥ	person	person/M
ⲍⲉⲗⲫⲁ	person	person/F
ⲍⲏⲛⲁ	person	person/M
ⲍⲟⲣⲟⲃⲁⲃⲉⲗ	person	person/M
ⲏⲥⲁⲓⲁⲥ	person	person/M
ⲏⲥⲁⲩ	person	person/M
ⲑⲉⲟⲇⲟⲣⲟⲥ	person	person/M
ⲑⲉⲩⲧⲁⲥ	person	person/M
ⲑⲉⲱⲇⲱⲣⲟⲥ	person	person/M
ⲑⲉⲱⲫⲓⲗⲟⲥ	person	person/M
ⲑⲱⲙⲁⲥ	person	person/M
ⲓⲁⲕⲕⲱⲃⲟⲥ	person	person/M
ⲓⲁⲕⲱⲃ	person	person/M
ⲓⲁⲕⲱⲃⲟⲥ	person	person/M
ⲓⲁⲙⲃⲣⲏⲥ	person	person/M
ⲓⲁⲛⲛⲏⲥ	person	person/M
ⲓⲁⲥⲥⲱⲛ	person	person/M
ⲓⲁⲥⲱⲛ	person	person/M
ⲓⲉⲍⲉⲕⲓⲏⲗ	person	person/M
ⲓⲉⲣⲉⲙⲓⲁⲥ	person	person/M
ⲓⲉⲣⲏⲙⲓⲁⲥ	person	person/M
ⲓⲉⲥⲥⲁⲓ	person	person/M
ⲓⲉⲭⲟⲛⲓⲁⲥ	person	person/M
ⲓⲏⲥⲟⲩⲥ	person	person/M
ⲓⲟⲣⲇⲁⲛⲏⲥ	person	person/M
ⲓⲟⲩⲇⲁ	person	person/M
ⲓⲟⲩⲇⲁⲥ	person	person/M
ⲓⲟⲩⲗⲓⲁ	person	person/F
ⲓⲟⲩⲗⲓⲟⲥ	person	person/M
ⲓⲟⲩⲛⲓⲁ	person	person/F
ⲓⲟⲩⲥⲧⲟⲥ	person	person/M
ⲓⲥ	person	person/M
ⲓⲥⲁⲁⲕ	person	person/M
ⲓⲥⲙⲁⲏⲗ	person	person/M
ⲓⲱϩⲁⲛⲏⲥ	person	person/M
ⲓⲱϩⲁⲛⲛⲁ	person	person/F
ⲓⲱϩⲁⲛⲛⲏⲥ	person	person/M
ⲓⲱⲁⲛⲛⲏⲥ	person	person/M
ⲓⲱⲃⲏⲇ	person	person/M
ⲓⲱⲏⲗ	person	person/M
ⲓⲱⲣⲁⲙ	person	person/M
ⲓⲱⲥⲁⲫⲁⲧ	person	person/M
ⲓⲱⲥⲏ	person	person/M
ⲓⲱⲥⲏⲥ	person	person/M
ⲓⲱⲥⲏⲫ	person	person/M
ⲓⲱⲥⲓⲁⲥ	person	person/M
ⲕⲁⲓⲛ	person	person/M
ⲕⲁⲓⲟⲥ	person	person/M
ⲕⲁⲓⲫⲁⲥ	person	person/M
ⲕⲁⲥⲓⲁⲛⲟⲥ	person	person/M
ⲕⲏⲫⲁⲥ	person	person/M
ⲕⲗⲁⲩⲇⲓⲟⲥ	person	person/M
ⲕⲟⲣⲛⲏⲗⲓⲟⲥ	person	person/M
ⲕⲟⲩⲁⲣⲧⲟⲥ	person	person/M
ⲕⲣⲓⲥⲡⲟⲥ	person	person/M
ⲕⲣⲟⲛⲟⲥ	person	person/M
ⲕⲩⲣⲓⲛⲟⲥ	person	person/M
ⲗⲁⲍⲁⲣⲟⲥ	person	person/M
ⲗⲉⲅⲉⲱⲛ	person	person/M
ⲗⲉⲅⲓⲱⲛ	person	person/M
ⲗⲓⲁ	person	person/F
ⲗⲓⲃⲁⲛⲟⲥ	person	person/M
ⲗⲟⲩⲕⲁⲥ	person	person/M
ⲗⲟⲩⲕⲓⲟⲥ	person	person/M
ⲗⲩⲥⲓⲁⲥ	person	person/M
ⲗⲱⲧ	person	person/M
ⲙ ⲙⲁⲑⲟⲩⲥⲁⲗⲁ	person	person/M
ⲙ ⲙⲁⲗⲉⲏⲗ	person	person/M
ⲙ ⲙⲁⲧⲧⲁⲑⲁ	person	person/M
ⲙ ⲙⲁⲧⲧⲁⲑⲓⲁⲥ	person	person/M
ⲙ ⲙⲉⲛⲛⲁ	person	person/M
ⲙⲁⲑⲓⲁⲥ	person	person/M
ⲙⲁⲙⲙⲱⲛⲁⲥ	person	person/M
ⲙⲁⲛⲁⲥⲥⲏ	person	person/M
ⲙⲁⲣⲑⲁ	person	person/F
ⲙⲁⲣⲓϩⲁⲙ	person	person/F
ⲙⲁⲣⲓⲁ	person	person/F
ⲙⲁⲣⲕⲟⲥ	person	person/M
ⲙⲁⲧⲑⲁⲙ	person	person/M
ⲙⲉⲗⲭⲓⲥⲉⲇⲉⲕ	person	person/M
ⲙⲉⲥⲥⲓⲁⲥ	person	person/M
ⲙⲓⲭⲁⲏⲗ	person	person/M
ⲙⲙⲁⲑⲑⲁⲑⲓⲁⲥ	person	person/M
ⲙⲱⲩⲥⲏⲥ	person	person/M
ⲛ ⲁⲣⲭⲓⲡⲡⲟⲥ	person	person/M
ⲛ ⲉⲛⲱⲥ	person	person/M
ⲛ ⲉⲡⲁⲫⲣⲁ	person	person/M
ⲛ ⲉⲡⲁⲫⲣⲟⲇⲓⲧⲟⲥ	person	person/M
ⲛ ⲍⲁⲃⲟⲩⲗⲱⲛ	person	person/M
ⲛ ⲑⲁⲣⲣⲁ	person	person/M
ⲛ ⲓⲱⲛⲁⲥ	person	person/M
ⲛ ⲕⲁⲓⲛⲁⲙ	person	person/M
ⲛ ⲟⲛⲏⲥⲓⲫⲟⲣⲟⲥ	person	person/M
ⲛ ⲥⲁⲗⲁ	person	person/M
ⲛ ⲧⲓⲃⲉⲣⲓⲟⲥ	person	person/M
ⲛ ⲭⲟⲩⲍⲁ	person	person/M
ⲛⲁⲁⲥⲥⲱⲛ	person	person/M
ⲛⲁⲑⲁⲛⲁⲏⲗ	person	person/M
ⲛⲁⲣⲕⲓⲥⲥⲟⲥ	person	person/M
ⲛⲉⲫⲑⲁⲗⲉⲓⲙ	person	person/M
ⲛⲏⲣⲉⲁⲥ	person	person/M
ⲛⲓⲕⲟⲇⲏⲙⲟⲥ	person	person/M
ⲛⲙ ⲗⲩⲥⲁⲛⲓⲁⲥ	person	person/M
ⲛⲙ ⲙⲁⲑⲑⲁⲓⲟⲥ	person	person/M
ⲛⲙ ⲡ ⲁⲙⲙⲱⲛⲁⲥ	person	person/M
ⲟⲇⲟⲗⲗⲁ	person	person/F
ⲟⲍⲉⲓⲁⲥ	person	person/M
ⲟⲛⲏⲥⲓⲙⲟⲥ	person	person/M
ⲟⲩⲣⲓⲁⲥ	person	person/M
ⲡ ϩⲣⲙⲏⲥ	person	person/M
ⲡ ⲁⲛⲇⲓⲭⲣⲏⲥⲧⲟⲥ	person	person/M
ⲡ ⲁⲛⲧⲓⲭⲣⲏⲥⲧⲟⲥ	person	person/M
ⲡ ⲁⲛⲧⲓⲭⲣⲓⲏⲥⲟⲩⲥⲧⲟⲥ	person	person/M
ⲡ ⲙⲁⲙⲱⲛⲁⲥ	person	person/M
ⲡⲁⲙⲃⲱ	person	person/M
ⲡⲁⲣⲙⲉⲛⲁⲥ	person	person/M
ⲡⲁⲥⲧⲁⲙⲱⲛ	person	person/M
ⲡⲁⲩⲗⲉ	person	person/M
ⲡⲁⲩⲗⲟⲥ	person	person/M
ⲡⲉⲣⲥⲓⲥ	person	person/F
ⲡⲉⲧⲣⲟⲥ	person	person/M
ⲡⲓⲗⲁⲧⲟⲥ	person	person/M
ⲡⲟⲛⲧⲓⲟⲥ	person	person/M
ⲡⲟⲣⲕⲓⲟⲥ	person	person/M
ⲥⲁⲇⲱⲕ	person	person/M
ⲥⲁⲗⲁⲑⲓⲏⲗ	person	person/M
ⲥⲁⲗⲙⲱⲛ	person	person/M
ⲥⲁⲙⲟⲩⲏⲗ	person	person/M
ⲥⲁⲙⲯⲱⲛ	person	person/M
ⲥⲁⲟⲩⲗ	person	person/M
ⲥⲁⲣⲁⲡⲓⲟⲛ	person	person/M
ⲥⲁⲣⲣⲁ	person	person/F
ⲥⲁⲧⲁⲛⲁⲥ	person	person/M
ⲥⲁⲩⲗⲟⲥ	person	person/M
ⲥⲓⲗⲁⲥ	person	person/M
ⲥⲓⲗⲟⲩⲁⲛⲟⲥ	person	person/M
ⲥⲓⲙⲱⲛ	person	person/M
ⲥⲟⲗⲟⲙⲱⲛ	person	person/M
ⲥⲧⲉⲫⲁⲛⲟⲥ	person	person/M
ⲥⲩⲙⲉⲱⲛ	person	person/M
ⲥⲱⲥⲓⲡⲁⲧⲣⲟⲥ	person	person/M
ⲧⲁⲃⲓⲑⲁ	person	person/F
ⲧⲉⲣⲧⲓⲟⲥ	person	person/M
ⲧⲉⲣⲧⲩⲗⲗⲟⲥ	person	person/M
ⲧⲓⲃⲉⲣⲓⲁⲥ	person	person/M
ⲧⲓⲙⲁⲓⲟⲥ	person	person/M
ⲧⲓⲙⲟⲑⲉⲟⲥ	person	person/M
ⲧⲓⲧⲟⲥ	person	person/M
ⲧⲟⲣⲕⲁⲥ	person	person/F
ⲧⲩⲙⲏⲧⲣⲓⲟⲥ	person	person/M
ⲧⲩⲭⲓⲕⲟⲥ	person	person/M
ⲫⲁⲛⲟⲩⲏⲗ	person	person/M
ⲫⲁⲣⲁⲱ	person	person/M
ⲫⲁⲣⲉⲥ	person	person/M
ⲫⲏⲗⲓⲝ	person	person/M
ⲫⲏⲥⲧⲟⲥ	person	person/M
ⲫⲓⲗⲁⲅⲣⲓⲟⲥ	person	person/M
ⲫⲓⲗⲓⲡⲡⲟⲥ	person	person/M
ⲫⲓⲗⲟⲑⲉⲟⲥ	person	person/M
ⲫⲓⲗⲟⲑⲉⲥ	person	person/M
ⲫⲟⲓⲃⲁⲙⲙⲱⲛ	person	person/M
ⲭⲁⲏⲗ	person	person/M
ⲭⲣⲓⲥⲧⲟⲥ	person	person/M
ⲭⲣⲓⲥⲧⲟⲫⲟⲣⲟⲥ	person	person/M
ⲱⲥⲁⲛⲛⲁ	person	person/M
ϣⲓⲏⲧ	place	place/F
ϩⲉⲣⲙⲏⲥ	place	place/M
ϩⲓⲉⲣⲟⲥⲟⲗⲩⲙⲁ	place	place/F
ϩⲓⲉⲣⲟⲩⲥⲁⲗⲏⲙ	place	place/F
ϩⲣⲱⲙⲏ	place	place/F
ⲁⲣⲓⲙⲁⲑⲁⲓⲟⲥ	place	place/M
ⲃⲁⲃⲩⲗⲱⲛ	place	place/F
ⲃⲏⲇⲥⲁⲓⲇⲁ	place	place/F
ⲃⲏⲑⲁⲛⲓⲁ	place	place/F
ⲅⲁⲃⲃⲁⲑⲁ	place	place/F
ⲅⲁⲗⲓⲗⲁⲓⲁ	place	place/F
ⲅⲟⲗⲅⲟⲑⲁ	place	place/M
ⲅⲟⲙⲟⲣⲣⲁ	place	place/F
ⲇⲁⲗⲙⲁⲛⲟⲩⲑⲁ	place	place/F
ⲇⲁⲙⲁⲥⲕⲟⲥ	place	place/M
ⲇⲉⲕⲁⲡⲟⲗⲓⲥ	place	place/F
ⲉⲓⲥⲣⲁⲏⲗ	place	place/M
ⲉⲫⲉⲥⲟⲥ	place	place/M
ⲓⲟⲩⲇⲁⲓⲁ	place	place/F
ⲓⲥⲣⲁⲏⲗ	place	place/M
ⲕⲁⲓⲥⲁⲣⲓⲁ	place	place/F
ⲕⲁⲡⲁⲣⲛⲁⲟⲩⲙ	place	place/M
ⲕⲁⲫⲁⲣⲛⲁⲟⲩⲙ	place	place/M
ⲕⲉⲥⲁⲣⲓⲁ	place	place/F
ⲕⲏⲙⲉ	place	place/F
ⲕⲩⲡⲣⲟⲥ	place	place/M
ⲗⲁⲟⲇⲓⲕⲓⲁ	place	place/F
ⲛⲁⲍⲁⲣⲉⲑ	place	place/M
ⲛⲉⲁⲡⲟⲗⲓⲥ	place	place/F
ⲡ ⲁⲛⲧⲣⲓⲁⲥ	place	place/M
ⲡ ⲡⲟⲛⲧⲟⲥ	place	place/M
ⲡⲁⲣⲓⲅⲟⲣⲓ	place	place/M
ⲣⲁⲕⲟⲧⲉ	place	place/F
ⲥⲉⲗⲉⲩⲕⲓⲁ	place	place/F
ⲥⲓⲛⲁ	place	place/F
ⲥⲓⲱⲛ	place	place/F
ⲥⲟⲇⲟⲙⲁ	place	place/F
ⲥⲩⲣⲓⲁ	place	place/F
ⲧ ⲁⲛⲧⲓⲟⲭⲓⲁ	place	place/F
ⲧⲁⲣⲥⲟⲥ	place	place/M
ⲧⲣⲱⲁⲥ	place	place/F
ⲧⲩⲣⲟⲥ	place	place/M
ⲭⲁⲛⲁⲁⲛ	place	place/F
ⲁⲃⲓⲁⲥ	person	person/M
