# ONTO DATA
# Sources: Freebase, GUM, WSJ/PTB, added data by Amir Zeldes (see licenses)
°	quantity	quantity/plural
“ah”s	abstract	abstract/plural
“um”s	abstract	abstract/plural
%	quantity	quantity
'50s	time	time/plural
'60s	time	time/plural
'70s	time	time/plural
'80s	time	time/plural
1	time	time
100000	quantity	quantity
11-Sep	event	event
12	time	time
1540s	time	time/plural
18-year-old	person	person
1800s	time	time/plural
1890	time	time
1906	time	time
1920s	time	time/plural
1940s	time	time/inanim
1950s	time	time/inanim
1960s	time	time
1969	time	time
1970	time	time
1970s	time	time
1980s	time	time/plural
1987	time	time
1989	time	time
1990s	time	time/plural
1994	time	time
20	quantity	quantity
2000	time	time
2002	time	time
2005	time	time
2006	time	time
2007	time	time
2008	time	time
2009	time	time
2010	time	time
2011	time	time
2014	time	time
2015	time	time
2050	time	time
20s	time	time/inanim
213	place	place
23	time	time
24	quantity	quantity
25	quantity	quantity
2Pac	person	person
3	quantity	quantity
34th	abstract	abstract
4th	event	event
5	quantity	quantity
60000	quantity	quantity
6:00am	time	time
747	object	object
747-400	object	object/inanim
9	time	time
9/11-related	event	event
A	object	object
a	organization	organization
A.D.	time	time-unit
a.m.	time	time/inanim
aardvark	animal	animal
abatement	abstract	abstract/inanim
abbess	person	person/female
abbot	person	person/male
abducted	person	person
aberration	abstract	abstract/inanim
abilities	abstract	abstract
ability	abstract	abstract/inanim
able	abstract	abstract
abolition	event	event/inanim
abomination	abstract	abstract/inanim
abortion	event	event/inanim
abortion-right	abstract	abstract/inanim
about	quantity	quantity
absence	abstract	abstract/inanim
absenteeism	abstract	abstract/inanim
absorber	object	object/inanim
abstention	event	event/inanim
abuse	event	event/inanim
academia	organization	organization
academic	abstract	abstract
academician	person	person
academy	organization	organization
acceleration	event	event/inanim
accent	abstract	abstract/inanim
acceptance	abstract	abstract/inanim
access	event	event/inanim
Accident	abstract	abstract
accident	abstract	abstract/inanim
accommodation	place	place/inanim
accompaniment	abstract	abstract/inanim
accompanist	person	person
accompli	abstract	abstract/inanim
accomplishment	abstract	abstract/inanim
accord	abstract	abstract/inanim
accordance	abstract	abstract/inanim
accordionist	person	person
account	abstract	abstract/inanim
accountability	abstract	abstract/inanim
accountant	person	person
accounting	abstract	abstract/inanim
accouterments	object	object
accumulation	abstract	abstract/inanim
accuracy	abstract	abstract/inanim
accusation	abstract	abstract/inanim
accuser	person	person
ace	abstract	abstract/inanim
ace	person	person
acetylene	substance	substance/inanim
acfor	person	person
achievements	abstract	abstract
acne	abstract	disease
acorn	plant	plant/inanim
Acphillips	person	person
acquaintance	person	person
acquirer	person	person
acquisition	event	event/inanim
acre	place	place/inanim
act	abstract	abstract/inanim
Act	object	object
acting	abstract	abstract/inanim
action	event	event/inanim
actions	abstract	abstract
active-matrix	abstract	abstract/inanim
activist	person	person
activity	abstract	abstract
activity	event	event/inanim
actor	person	person
actor-manager	person	person
actors	person	person
actress	person	person
actriz	person	person
actuary	person	person
actuary	person	person
acupuncturist	person	person
ad	abstract	abstract
ad-agency	organization	organization
adage	abstract	abstract/inanim
Adams	person	person
adaptations	abstract	abstract/plural
addict	person	person
addition	event	event
address	place	place/inanim
adequacy	abstract	abstract/inanim
adhesive	substance	substance/inanim
adjudicator	person	person
adjusters	object	object
adjustment	abstract	abstract/inanim
adman	person	person
admen	person	person/plural
administration	organization	organization
administrations	organization	organization/plural
administrator	person	person
adminstration	organization	organization
admiral	person	person
admirer	person	person
admission	event	event/inanim
admonition	event	event/inanim
ads	abstract	abstract
adult	person	person
adults	person	person
advance	abstract	abstract/inanim
advancement	event	event/inanim
advantage	abstract	abstract/inanim
advantages	abstract	abstract
advent	event	event/inanim
adventure	event	event/inanim
adventurer	person	person
adversary	person	person
advert	abstract	abstract/inanim
advertisement	abstract	abstract/inanim
advertiser	person	person
advertising	abstract	abstract
advice	abstract	abstract/inanim
adviser	person	person
advisory	abstract	abstract/inanim
advisory	event	event/inanim
advocacy	abstract	abstract/inanim
advocate	person	person
aegis	abstract	abstract/inanim
aerialist	person	person
aerobics	abstract	abstract/inanim
aeroplane	object	object
aerospace	abstract	abstract/inanim
affair	abstract	abstract/inanim
affect	abstract	abstract/inanim
affenpinscher	animal	animal
affidavit	abstract	abstract/inanim
affiliate	person	person
affiliation	abstract	abstract/inanim
affineur	person	person
affinity	abstract	abstract/inanim
affirmative-action	abstract	abstract/inanim
affluent	person	person
Afghan	person	person
AFP	organization	organization
African	person	person
aftereffect	abstract	abstract/inanim
afterlife	abstract	abstract/inanim
aftermath	abstract	abstract/inanim
afternoon	time	time/inanim
aftershock	abstract	abstract/inanim
age	abstract	abstract/inanim
agencies	organization	organization/plural
agency	organization	organization
agenda	abstract	abstract
agent	person	person
aggressiveness	abstract	abstract/inanim
agility	abstract	abstract/inanim
agitation	abstract	abstract/inanim
ago	time	time
agrarian	person	person
agreement	abstract	abstract/inanim
agriculturalist	person	person
agriculture	abstract	abstract
agriculturist	person	person
agronomist	person	person
aid	abstract	abstract
aide	person	person
ail	abstract	abstract/inanim
ailment	abstract	disease/inanim
AIM	abstract	abstract
aim	abstract	abstract/inanim
aioli	substance	substance
air	abstract	abstract
air-conditioning	abstract	abstract/inanim
air-freight	object	object/inanim
air-passenger	person	person
air-pollution	abstract	abstract/inanim
air-port/train	place	place
air-quality	abstract	abstract
air-traffic	abstract	abstract/inanim
airborne-radar	object	object/inanim
aircraft	object	object/inanim
aircraft-electronics	object/plural	object/plural/inanim
airfield	place	place/inanim
airing	event	event/inanim
airlift	event	event/inanim
airline	organization	organization/inanim
airliner	organization	organization/inanim
airlines	organization	organization/plural
airman	person	person
airplane	object	object/inanim
airport	place	place
airports	object	object
airwave	abstract	abstract/inanim
airway	place	place/inanim
alarm	abstract	abstract/inanim
Albanian	person	person
Albanian	person	person
album	object	object/inanim
alchemist	person	person
alcohol	substance	substance/inanim
alcoholic	person	person
alcoholism	abstract	abstract/inanim
ale	substance	substance/inanim
alert	person	person
Algerian	person	person
alimony	abstract	abstract/inanim
all	abstract	abstract
allegation	abstract	abstract/inanim
allegations	abstract	abstract/plural
allegiance	abstract	abstract/inanim
allegory	abstract	abstract/inanim
allergy	abstract	disease/inanim
alley	place	place/inanim
alliance	abstract	abstract/inanim
allies	person	person/plural
alligator	animal	animal
allocation	abstract	abstract/inanim
allotment	abstract	abstract/inanim
allowance	abstract	abstract/inanim
allrightnik	person	person
Allton	person	person
allure	abstract	abstract/inanim
allusion	abstract	abstract/inanim
ally	person	person
almanac	object	object
Almanac	organization	organization
almoner	person	person
alpaca	animal	animal
Alphabet	abstract	abstract
alphabet	abstract	abstract/inanim
alphabets	abstract	abstract
alt.religion.scientology	place	place
altar	place	place/inanim
alternative	abstract	abstract/inanim
altitude	quantity	quantity/inanim
aluminum	substance	substance/inanim
am	time	time
amateur	person	person
amazement	abstract	abstract/inanim
ambassador	person	person
ambiance	abstract	abstract/inanim
ambiguity	abstract	abstract
ambiguity	abstract	abstract/inanim
ambition	abstract	abstract/inanim
ambivalence	abstract	abstract/inanim
ambulance	object	object/inanim
amendment	abstract	abstract
amenities	abstract	abstract/plural
amenities	place	place
amenity	abstract	abstract/inanim
America	place	place
American	person	person
American	person	person
Americana	abstract	abstract/inanim
americans	object	object/inanim
ammo	object	object/inanim
amnesty	abstract	abstract/inanim
amount	quantity	quantity
amounts	quantity	quantity/plural
amphibian	animal	animal
amplifier	object	object/inanim
amusement	abstract	abstract/inanim
analysis	abstract	abstract
analyst	person	person
Analytics	abstract	abstract
analytics	abstract	abstract/inanim
analyzing	event	event/inanim
anarchy	abstract	abstract
anathema	abstract	abstract/inanim
anatomist	person	person
anatomy	abstract	abstract
ancestors	person	person/plural
anchor	object	object/inanim
anchorage	place	place/inanim
anchorman	person	person/male
and	object	object
Andorran	person	person
andrillae	animal	animal
anemia	abstract	disease/inanim
anemone	animal	animal
anemones	animal	animal
anesthesiologist	person	person
angel	abstract	abstract/inanim
Angelou	person	person
Angels	organization	organization
anger	abstract	abstract
Angolan	person	person
anguish	abstract	abstract/inanim
animal	animal	animal
animal-rights	abstract	abstract/plural
animals	animal	animal
animation	abstract	abstract/inanim
animator	person	person
annals	abstract	abstract/plural
anniversaries	event	event/plural
anniversary	event	event
anniversary	event	event/inanim
anniversay	event	event
announcement	abstract	abstract
announcer	person	person
annuals	plant	plant
annuity	quantity	quantity/inanim
annum	time	time-unit/inanim
anomalies	abstract	abstract/inanim
anomaly	abstract	abstract/inanim
anonymity	abstract	abstract/inanim
Anonymous	person	person
another	place	place
answer	abstract	abstract/inanim
answering	event	event/inanim
answers	abstract	abstract
ant	animal	animal
antagonist	person	person
Antarctic	place	place
Antarctica	place	place
antarctician	person	person
ante	quantity	quantity/inanim
anteater	animal	animal
antecedent	abstract	abstract/inanim
antelope	animal	animal
anthem	abstract	abstract/inanim
anthology	abstract	abstract/inanim
anthrax	abstract	disease/inanim
anthropologist	person	person
anti-abortion	abstract	abstract/inanim
anti-abortionist	person	person
anti-airline	abstract	abstract/inanim
anti-apartheid	abstract	abstract/inanim
anti-foreigner	abstract	abstract/inanim
anti-government	abstract	abstract/inanim
anti-outsider	abstract	abstract/inanim
antibiotic	substance	substance/inanim
antibody	substance	substance/inanim
anticipation	abstract	abstract/inanim
antigen	substance	substance/inanim
antihero	person	person
antiquarian	person	person
ants	animal	animal/plural
ants	animal	animal/plural
anxiety	abstract	abstract/inanim
any	event	event/inanim
anybody	person	person
anyone	person	person
anything	object	object
apartheid	abstract	abstract/inanim
apartment	place	place/inanim
ape	animal	animal
aphid	person	person
aphids	object	object/plural
Aphrodite	person	person
API	abstract	abstract/inanim
apologist	person	person
apostle	person	person
apothecary	person	person
apparat	object	object/inanim
apparatus	object	object/inanim
apparel	object	object/inanim
appeal	event	event/inanim
appearance	abstract	abstract
appellate-court	organization	organization
appendage	object	object/inanim
appetite	abstract	abstract/inanim
applause	event	event/inanim
apple	object	object/inanim
apple-industry	organization	organization
appliance	object	object/inanim
appliances	object	object
applicability	abstract	abstract/inanim
applicant	person	person
application	abstract	abstract/inanim
applying	event	event
appointee	person	person
appointment	event	event/inanim
appraisal	abstract	abstract/inanim
appraiser	person	person
appreciation	abstract	abstract/inanim
apprehension	abstract	abstract/inanim
approach	abstract	abstract
approach	abstract	abstract/inanim
appropriation	abstract	abstract/inanim
approval	event	event/inanim
Apr.	time	time-unit/inanim
April	time	time-unit/inanim
aquanaut	person	person
aquarium	object	object/inanim
aquarium	place	place/inanim
Arabic	abstract	abstract
arabist	person	person
Arabs	person	person/plural
arachnologist	person	person
arbitrage	abstract	abstract/inanim
arbitrager	person	person
arbitration	abstract	abstract/inanim
arborist	person	person
arbovirologist	person	person
arcade	place	place/inanim
archaeologist	person	person
archbishop	person	person
archeologist	person	person
archimandrite	person	person
architect	person	person
architects	person	person/plural
architecture	object	object
archivist	person	person
archness	abstract	abstract/inanim
ardor	abstract	abstract/inanim
Area	place	place
area	place	place/inanim
areas	place	place
Arena	place	place
arena	place	place/inanim
argali	animal	animal
Argentinian	person	person
argument	abstract	abstract/inanim
ariegeois	animal	animal
arm	object	object/inanim
armadillo	animal	animal
Armenian	person	person
armies	organization	organization/plural
armor	object	object/inanim
armpit	object	object/inanim
arms	object	object/plural
arms-control	abstract	abstract/inanim
army	organization	organization
aroma	abstract	abstract/inanim
Aromanian	person	person
around	person	person
arrangement	abstract	abstract/inanim
arranger	person	person
array	place	place/inanim
arrear	abstract	abstract/inanim
arrest	event	event/inanim
arrival	event	event/inanim
Arrogance	abstract	abstract
arrogance	abstract	abstract/inanim
arrogant	person	person
arrow	object	object/inanim
arsenal	abstract	abstract/inanim
arson	event	event/inanim
art	abstract	abstract
arteries	object	object/inanim
artery	object	object/inanim
artery	object	object/inanim
article	object	object
articles	abstract	abstract
artifact	object	object/inanim
artifacts	object	object
artillerist	person	person
artillery	place	place/inanim
artisan	person	person
artist	person	person
arts	abstract	abstract
artwork	abstract	abstract/inanim
Aruban	person	person
as	place	place
Asahi	organization	organization
Asahi	substance	substance/inanim
asbestos	substance	substance/inanim
asbestos-disease	abstract	disease/inanim
ash	substance	substance/inanim
Ashtabula	place	place/inanim
askari	person	person
asking	abstract	abstract/inanim
aspect	abstract	abstract/inanim
aspects	abstract	abstract
aspersion	abstract	abstract/inanim
asphalt	substance	substance/inanim
aspiration	abstract	abstract/inanim
ass	animal	animal/inanim
ass	object	object/inanim
ass	person	person
assassin	person	person
assassination	event	event/inanim
assault	event	event/inanim
assayer	person	person
assemblage	object	object/inanim
assembly	organization	organization
assent	abstract	abstract/inanim
assertion	abstract	abstract/inanim
asses	object	object/plural
assessment	abstract	abstract/inanim
asset	abstract	abstract/inanim
asset	abstract	abstract/inanim
assignment	abstract	abstract/inanim
assistance	abstract	abstract/inanim
assistant	person	person
associate	person	person
association	organization	organization/inanim
associations	abstract	abstract/plural
assortment	abstract	abstract/inanim
assumption	abstract	abstract/inanim
assurance	abstract	abstract/inanim
assyriologist	person	person
asthma	abstract	disease/inanim
astrobiologist	person	person
astrologer	person	person
astronaut	person	person
astronauts	person	person
astronomer	person	person
astrophysicist	person	person
asylum	person	person
At	time	time
AT&T	organization	company
Athena	person	person
athlete	person	person
athlete	person	person
athletes	person	person/plural
athletic-shoe	object	object/inanim
Atlantis	object	object
atm	object	object/inanim
atmosphere	abstract	abstract
atolls	place	place
atoms	substance	substance/plural
attaché	person	person
attache	person	person
attack	event	event
attack	event	event/inanim
attacked	event	event
attacks	abstract	abstract
attempt	event	event
attempts	event	event
attendance	abstract	abstract/inanim
attendant	person	person
attendees	person	person
attention	event	event
attic	place	place
attitude	abstract	abstract
attitudes	abstract	abstract/plural
attorney	person	person
attorney-consultant	person	person
attraction	object	object/inanim
attractions	abstract	abstract
attractiveness	abstract	abstract/inanim
attribute	abstract	abstract/inanim
auction	event	event/inanim
auctioneer	person	person
audience	person	person
audiences	person	person
audiologist	person	person
audit	event	event/inanim
auditor	person	person
Aug.	time	time/inanim
August	time	time-unit/inanim
aunt	person	person/female
aureus	object	object/inanim
Aureus	organization	company
austerity	abstract	abstract/inanim
Australia	place	place
Australian	person	person
Austrian	person	person
authenticity	abstract	abstract/inanim
author	person	person
authorities	organization	organization
authorities	organization	organization/plural
authority	abstract	abstract/inanim
authorization	abstract	abstract/inanim
auto	object	object/inanim
auto-dealer	person	person
auto-emission	abstract	abstract/inanim
auto-maker	organization	company/plural
auto-market	abstract	abstract/inanim
auto-sale	event	event/inanim
autograph	object	object
automaker	organization	company
automation	event	event/inanim
automobile	object	object/inanim
autonomy	abstract	abstract/inanim
autumn	time	time-unit/inanim
avail	abstract	abstract/inanim
availability	abstract	abstract/inanim
Avai\'o\'vuna	place	place
avalanche	event	event/inanim
Ave	place	place
Avenue	place	place
avenue	place	place/inanim
average	quantity	quantity/inanim
aversion	abstract	abstract/inanim
aviatio	abstract	abstract
aviation	abstract	abstract
awakening	event	event/inanim
award	abstract	abstract/inanim
awarding	event	event/inanim
awareness	abstract	abstract/inanim
awkwardness	abstract	abstract/inanim
ayatollah	person	person
aywv	organization	organization
azawakh	animal	animal
Azeri	person	person
b-boy	person	person
b-flat	abstract	abstract/inanim
B.C.	time	time-unit
babel	abstract	abstract/inanim
Babel	place	place/inanim
babies	person	person/plural
baboon	animal	animal
baby	person	person/female
baby	person	person/male
babysitter	person	person
baccalaureate	abstract	abstract/inanim
bachelor	person	person
back	object	object
back-up	abstract	abstract/inanim
backbone	abstract	abstract/inanim
backdrop	abstract	abstract/inanim
backer	person	person
background	abstract	abstract
backhoe	object	object/inanim
backing	abstract	abstract/inanim
backlash	event	event/inanim
backlog	abstract	abstract/inanim
backseat	abstract	abstract/inanim
backside	place	place/inanim
backyard	place	place/inanim
bacon	object	food/inanim
bacteria	animal	animal/plural
bacteriologist	person	person
bacterium	animal	animal
badger	animal	animal
bag	object	object
baggage	abstract	abstract/inanim
bagpipe	object	object/inanim
bags	object	object
Bahamian	person	person
Bahraini	person	person
bail	abstract	abstract/inanim
bailiff	person	person
bailout	event	event/inanim
baker	person	person
baksheesh	abstract	abstract/inanim
balance	abstract	abstract/inanim
bale	object	object/inanim
Balisage	event	event/inanim
ball	object	object/inanim
balloon	object	object/inanim
balloonist	person	person
balloons	object	object
ballot	object	object
balloting	event	event/inanim
ballpark	place	place/inanim
ballplayer	person	person
ballroom	place	place/inanim
balls	object	object/plural
ban	event	event/inanim
banana	object	object/inanim
band	organization	organization
bandage	object	object/inanim
bandleader	person	person
bandog	animal	animal
bandurist	person	person
bandwagon	abstract	abstract/inanim
bane	abstract	abstract/inanim
bang	abstract	abstract/inanim
Bangladeshi	person	person
banguela	animal	animal
banishment	event	event/inanim
bank	organization	organization/inanim
bank	place	place/inanim
bank-credit	abstract	abstract/inanim
banker	person	person
banking	abstract	abstract/inanim
bankruptcies	event	event/plural
bankruptcy	event	event/inanim
bankruptcy-court	organization	organization
bankruptcy-law	abstract	abstract/inanim
bankruptcy-reorganization	event	event/inanim
banks	place	place
banner	object	object
banning	event	event/inanim
banshee	person	person
bar	place	place/inanim
barb	object	object/inanim
Barbadian	person	person
barbecue	object	object/inanim
barber	person	person
barbet	animal	animal
bard	person	person
bargain	abstract	abstract/inanim
bargain-basement	place	place/inanim
bargaining	event	event/inanim
barge	object	object/inanim
bargirl	person	person
barista	person	person
bark	substance	substance
barley	object	object/inanim
barn	place	place/inanim
barnacle	animal	animal/inanim
barnyard	place	place/inanim
barometer	object	object/inanim
baron	person	person
barracks	place	place/inanim
barrage	object	object/inanim
barrel	object	object/inanim
barrier	object	object
barrister	person	person
bars	object	object/plural
BART	organization	organization
bartender	person	person
bartering	abstract	abstract/inanim
basalt	substance	substance/inanim
Base	place	place
base	place	place/inanim
baseball	abstract	abstract
baseline	abstract	abstract
basement	place	place/inanim
basenji	animal	animal
basics	abstract	abstract/plural
basil	plant	plant
basils	plant	plant
basin	place	place/inanim
basis	abstract	abstract/inanim
basket	object	object/inanim
basketball	abstract	abstract
bassist	person	person
bassoonist	person	person
basters	object	object/plural
bastion	place	place/inanim
bat	animal	animal
batch	quantity	quantity/inanim
bathing	event	event/inanim
bathroom	place	place/inanim
battalion-2000	organization	organization
batter	object	object
batteries	object	object/plural
battery	object	object/inanim
batting	abstract	abstract/inanim
battle	event	event
battlefield	place	place/inanim
battlement	place	place/inanim
Bay	object	object
bay	place	place/inanim
bays	place	place
BBC	organization	organization
bc	event	event/inanim
BDSM	abstract	abstract
beach	object	object
beaches	place	place
beader	person	person
beadle	person	person
beagador	animal	animal
beagle	animal	animal
beagle-harrier	animal	animal
beak	place	place/inanim
beamter	person	person
bean	plant	plant/inanim
bear	animal	animal
bear-leader	person	person
bearing	abstract	abstract/inanim
beast	animal	animal
beastie	animal	animal
beasts	animal	animal
beaters	person	person/plural
beating	event	event/inanim
beauceron	animal	animal
beautician	person	person
beauty	abstract	abstract/inanim
beauty	person	person/female
beaver	animal	animal
beavertail	abstract	abstract/inanim
beavertails	abstract	abstract/plural
bed	place	place/inanim
bedder	person	person
bedpan	object	object/inanim
bedrock	substance	substance/inanim
bedroom	place	place/inanim
bee	animal	animal
beef	substance	food/inanim
beekeeper	person	person
beep	abstract	abstract/inanim
beeper	object	object/inanim
beeping	abstract	abstract/inanim
beer	substance	drink/inanim
beer-belly	object	object/inanim
beeswax	substance	substance/inanim
beet	plant	food/inanim
beetle	animal	animal
beetles	animal	animal
beggar	person	person
beginning	time	time/inanim
behalf	abstract	abstract
behavior	abstract	abstract/inanim
beheading	event	event/inanim
behemoth	animal	animal
behemoth	object	object/inanim
being	abstract	abstract/inanim
beings	person	person/plural
Belarusian	person	person
belch	event	event/inanim
belfries	place	place/inanim
belfry	place	place/inanim
Belgian	person	person
Belgium	place	country/inanim
belief	abstract	abstract/inanim
beliefs	abstract	abstract/plural
believer	person	person
Belizean	person	person
bell	object	object
bell-ringer	person	person
bellhop	person	person
bellman	person	person
bellringer	person	person
bellwether	animal	animal
belongings	object	object/plural
belt	place	place
beltway	place	place/inanim
bench	object	object/inanim
bencher	person	person
benchmark	abstract	abstract/inanim
benefactor	person	person
beneficiary	person	person
benefit	abstract	abstract/inanim
benefit-seeking	abstract	abstract/inanim
benefits	abstract	abstract
benshi	person	person
Bermudian	person	person
berthage	place	place/inanim
best	abstract	abstract
best-seller	object	object/inanim
bestiality	abstract	abstract/inanim
bet	abstract	abstract/inanim
beta	abstract	abstract/inanim
beta-thalassemia	abstract	disease/inanim
better	abstract	abstract
betting	abstract	abstract/inanim
Between	time	time
Bever	abstract	abstract
beverage	substance	substance/inanim
Bevernondelibreatekin	abstract	abstract
bias	abstract	abstract/inanim
bias	abstract	abstract/inanim
biathlete	person	person
bib	object	object
bibliographer	person	person
bibliophile	person	person
bicycle	object	object/inanim
bid	quantity	quantity/inanim
bid-to-cover	quantity	quantity/inanim
bidder	person	person
bidding	event	event/inanim
bigotry	abstract	abstract/inanim
bike	object	object/inanim
bill	place	place
billing	abstract	abstract/inanim
billion	quantity	quantity/inanim
billionaire	person	person
billionnaire	person	person
binge	event	event/inanim
biochemist	person	person
bioengineer	person	person
bioethicist	person	person
biographer	person	person
bioinformatician	person	person
biologist	person	person
biologists	person	person
biologists	person	person/plural
biology	abstract	abstract/inanim
biomedical-product	object	object/inanim
biometrician	person	person
biophysicist	person	person
biostatistician	person	person
biotechnician	person	person
biotechnology	abstract	abstract/inanim
biped	animal	animal
Bird	animal	animal
bird	animal	animal/inanim
Birdie	person	person
Birdman	person	person
Birds	abstract	abstract
birds	animal	animal/plural
birth	event	event/inanim
birthplace	place	place
bisben	animal	animal
bishop	person	person
bison	animal	animal
bit	quantity	quantity/inanim
bitch	person	person/female
bite	substance	food/inanim
bits	object	object
bitters	substance	substance/plural
black	abstract	abstract
blacksmith	person	person
bladder	object	object/inanim
blade	object	object/inanim
blame	abstract	abstract/inanim
blanding	abstract	abstract/inanim
blandness	abstract	abstract/inanim
blanket	object	object/inanim
blankets	object	object
Blarney	place	town/inanim
blast	event	event/inanim
bleach	substance	substance/inanim
blemish	abstract	abstract/inanim
blend	substance	substance/inanim
blender	object	object
blessing	abstract	abstract/inanim
blindfold	object	object/inanim
blini	substance	food/inanim
blink	abstract	abstract/inanim
blip	abstract	abstract/inanim
bloc	organization	organization
block	object	object/inanim
block	place	place/inanim
blockade	abstract	abstract/inanim
blocs	organization	organization/plural
blog	place	place/inanim
blogger	person	person
blonde	person	person/female
blood	substance	substance/inanim
bloodhound	animal	animal
blossom	plant	plant/inanim
blouses	object	object
blow	abstract	abstract/inanim
blowup	event	event/inanim
bludger	object	object/inanim
bludgers	object	object/plural
blue	abstract	abstract/inanim
blueblood	person	person
blueprint	abstract	abstract/inanim
Blvd	place	place
BMW	object	car/inanim
boa	animal	animal
board	object	object
board	organization	organization
boast	abstract	abstract/inanim
boat	object	object/inanim
boater	person	person
boatman	person	person
boats	object	object
boatwright	person	person
bobsleigher	person	person
bodies	object	object/plural
body	object	object/inanim
bodybuilder	person	person
bodyguard	person	person
boerboel	animal	animal
boiler	object	object/inanim
boiler-room	place	place/inanim
Bolden	person	person
bolonka	animal	animal
bolt	object	object/inanim
bomb	object	object/inanim
bombardment	event	event/inanim
bomber	object	object/inanim
bomber	person	person
bombing	event	event/inanim
bombshell	abstract	abstract/inanim
bombshell	object	object/inanim
bonanza	event	event/inanim
bond	abstract	abstract/inanim
bond-holder	person	person
bond-trading	abstract	abstract/inanim
bondbroker	person	person
bone	object	object/inanim
bonecarver	person	person
bonesetter	person	person
bonfire	object	object/inanim
bonnet	object	object/inanim
bonus	abstract	abstract/inanim
book	object	object
bookbinder	person	person
bookcase	object	object/inanim
booking	abstract	abstract/inanim
bookkeeper	person	person
bookkeeping	abstract	abstract
booklet	object	object/inanim
bookmaker	person	person
books	object	object/plural
bookseller	person	person
bookstores	place	place
boom	person	person
boomer	person	person
boon	abstract	abstract/inanim
boost	abstract	abstract/inanim
booster	person	person
boot	object	object/inanim
booth	place	place/inanim
booths	object	object
bootseller	person	person
border	place	place
borders	place	place/plural
bore	abstract	abstract/inanim
boredom	abstract	abstract/inanim
borough	place	town/inanim
borrower	person	person
borrowing	abstract	abstract/inanim
borzoi	animal	animal
bos	object	object/inanim
Bosnian	person	person
bosom	object	object/inanim
boss	person	person
boss	person	person
botanist	person	person
botany	abstract	abstract/inanim
both	place	place
botonist	person	person
bottle	object	object
bottleneck	object	object/inanim
bottles	object	object
bottom	place	place
bottoms	object	object
boulevard	place	place/inanim
bounce	abstract	abstract/inanim
bouncer	person	person
boundaries	place	place/plural
bounds	place	place/plural
bouquet	object	object/inanim
bourbon	substance	substance/inanim
bout	event	event/inanim
boutique	place	place/inanim
boutiques	place	place
bow	event	event
bowel	object	object/inanim
bowl	object	object/inanim
bowler	person	person
bowling	abstract	abstract/inanim
bowyer	person	person
box	object	object
boxer	animal	animal
boxes	object	object
boxes	object	object/plural
boy	person	person/male
boycott	abstract	abstract/inanim
boyfriend	person	person/male
boys	organization	organization
bra	object	object/inanim
bracket	abstract	abstract/inanim
brain	abstract	abstract
brain	object	object
brainchild	abstract	abstract/inanim
brains	object	object/plural
brake	object	object/inanim
bran	substance	food/inanim
branch	abstract	abstract/inanim
branches	organization	organization/plural
brand	abstract	abstract/inanim
brandy	substance	drink/inanim
brass	substance	metal/inanim
brassiere	object	object/inanim
brat	person	person
Braysmith	person	person
Brazilian	person	person
breach	abstract	abstract/inanim
bread	object	food/inanim
breadth	abstract	abstract/inanim
break	event	event/inanim
break-up	event	event/inanim
breakdown	event	event/inanim
breaker	abstract	abstract/inanim
breakfast	event	event/inanim
breaking	abstract	abstract/inanim
breakthrough	event	event/inanim
breakup	event	event/inanim
breast	place	place/inanim
breast-cancer	abstract	disease/inanim
breath	abstract	abstract/inanim
breather	abstract	abstract/inanim
breathing	abstract	abstract/inanim
breed	animal	animal
breeder	person	person
breeding	abstract	abstract/inanim
breezes	abstract	abstract/plural
Breton	person	person
brewer	person	person
brewery	place	place/inanim
brewing	abstract	abstract/inanim
brewmaster	person	person
briard	animal	animal
bribe	abstract	abstract/inanim
bribery	abstract	abstract/inanim
brick	object	object/inanim
bricklayer	person	person
brickmaker	person	person
bridge	place	place
brie	object	food/inanim
brief	object	object/inanim
briefcase	object	object/inanim
briefing	event	event/inanim
brigade	organization	organization
brigadier	person	person
brimstone	substance	substance/inanim
brine	substance	liquid/inanim
bringing	abstract	abstract/inanim
British	person	person
broadcast	event	event/inanim
broadcaster	person	person
broadcasters	person	person/plural
broadcasting	abstract	abstract/inanim
broadcasts	event	event/plural
Broadway	place	place
brochure	object	object/inanim
broker	person	person
broker-dealer	person	person
brokerage	abstract	abstract/inanim
brokering	abstract	abstract/inanim
bronze	object	object
bronzefounder	person	person
brooch	object	object/inanim
broom	object	object/inanim
brooms	object	object/plural
brooms	object	object/plural
broomsticks	object	object/plural
broth	substance	food/inanim
brother	person	person
Brotherhood	organization	organization
brow-beating	abstract	abstract/inanim
Browns	organization	organization
browse	event	event/inanim
browser	object	object
browsers	object	object
brug	animal	animal
brunch	event	event/inanim
brush	object	object/inanim
brushoff	event	event/inanim
brutality	abstract	abstract/inanim
bubble	abstract	abstract/inanim
buccaneer	person	person
buck	quantity	quantity/inanim
bucket	object	object/inanim
buckshot	object	object/inanim
Budd	person	person
Buddhism	abstract	abstract
buddy	person	person
budgerigar	animal	animal
budget	abstract	abstract
budgeting	abstract	abstract/inanim
budgets	abstract	abstract
buds	plant	plant
buffer	abstract	abstract/inanim
buffs	person	person/plural
bug	abstract	abstract/inanim
bugaboo	object	object/inanim
bugs	object	object
build-outs	abstract	abstract
builder	person	person
building	abstract	abstract
Building	place	place
buildings	place	place
buildup	abstract	abstract/inanim
built	abstract	abstract
bulb	object	object/inanim
Bulgarian	person	person
bulgur	substance	food/inanim
bulk	abstract	abstract
bulk-mail	object	object/inanim
bull	animal	animal
bull-boxer	animal	animal
bulldog	animal	animal
bulldozer	object	vehicle/inanim
bullet	object	object
bulletin	abstract	abstract/inanim
bullfighter	person	person
bullhorn	object	object/inanim
bullion	object	object/inanim
bullmastiff	animal	animal
bullocky	person	person
bulwark	object	object/inanim
bump	object	object/inanim
bumper	object	object/inanim
bunch	person	person
bunch	quantity	quantity/inanim
bunco	abstract	abstract/inanim
bundle	object	object/inanim
bunko-forgery	abstract	abstract/inanim
buoyancy	abstract	abstract/inanim
burden	abstract	abstract/inanim
bureau	organization	organization
bureaucracy	abstract	abstract/inanim
bureaucrat	person	person
bureaucrats	person	person/plural
burgers	object	object
burglar	person	person
burglary	event	event/inanim
burial	event	event/inanim
Burmese	person	person
burner	object	object/inanim
burning	event	event/inanim
burnout	event	event/inanim
bursar	person	person
burst	abstract	abstract/inanim
Burundian	person	person
bus	object	object
buses	object	object
bushel	quantity	quantity/inanim
bushes	plant	plant
bushranger	person	person
business	abstract	abstract
business	event	event
businesses	object	object/plural
businesses	organization	organization/plural
businessman	person	person
businessmen	person	person/plural
businesspeople	person	person/plural
businessperson	person	person
busker	person	person
bust	object	object/inanim
butane	substance	gas/inanim
butcher	person	person
butler	person	person
butt	object	object/inanim
butter	substance	substance/inanim
butterflies	animal	animal/plural
butterfly	animal	animal
buttero	person	person
button	object	object/inanim
buy	event	event/inanim
buy-back	event	event/inanim
buy-out	event	event/inanim
buyer	person	person
buying	abstract	abstract
buzzard	animal	animal
buzzword	abstract	abstract/inanim
buzzwords	abstract	abstract
by	time	time
bylaw	abstract	abstract/inanim
byline	abstract	abstract/inanim
byproduct	substance	substance/inanim
bystander	person	person
C.E.	time	time-unit
cab	object	car/inanim
cabinet	object	object/inanim
cabinets	object	object/plural
cable	object	object/inanim
cable-television	abstract	abstract/inanim
cable-tv	abstract	abstract/inanim
cable-tv-system	object	object/inanim
cache	place	place/inanim
cachet	abstract	abstract/inanim
cactus	plant	plant/inanim
caddie	person	person
caddy	person	person
cadet	person	person
cafe	place	place
cafes	place	place
cafeteria	place	place/inanim
cages	place	place/plural
cake	object	food/inanim
cakes	object	object
calamity	event	event/inanim
calculation	abstract	abstract/inanim
calendar	abstract	abstract/inanim
calf	animal	animal
Californian	person	person
call	event	event/inanim
caller	person	person
calligrapher	person	person
calling	abstract	abstract/inanim
callipygous	person	person
callous	object	object/inanim
calm	abstract	abstract/inanim
calves	animal	animal/plural
calves	object	body_part/plural
Cambodian	person	person
camel	animal	animal
camera	object	object
cameras	object	object
Cameroonian	person	person
camgirl	person	person
camp	place	place/inanim
campaign	abstract	abstract
campaigning	abstract	abstract/inanim
campaigns	abstract	abstract/plural
camps	place	place/plural
campus	place	place/inanim
can	person	person
Canada	place	place
Canadian	person	person
canary	animal	bird
Canaveral	place	place
cancellation	event	event/inanim
cancer	abstract	abstract/inanim
cancer-suppressor	object	medicine/inanim
candidacy	abstract	abstract/inanim
candidate	person	person
candidates	person	person
candies	substance	substance
candlelight	abstract	abstract/inanim
candlemaker	person	person
candor	abstract	abstract/inanim
candy	object	object
canning	abstract	abstract/inanim
cannon	object	object/inanim
canopy	person	person
cans	object	object
cantor	person	person
canvas	substance	substance/inanim
cap	abstract	abstract/inanim
capability	abstract	abstract/inanim
capacitor	object	object/inanim
capacity	abstract	abstract/inanim
capes	person	person/plural
capital	place	place/inanim
capital-formation	abstract	abstract/inanim
capital-gain	abstract	abstract/inanim
capital-good	abstract	abstract/inanim
capital-to-asset	abstract	abstract/inanim
capitalgain	abstract	abstract/inanim
capitalism	abstract	abstract/inanim
capitalist	abstract	abstract/inanim
capitalist	person	person
capitalization	abstract	abstract/inanim
Capote	person	person
capsules	object	object
captain	event	event
captive	person	person
capture	event	event/inanim
capybara	animal	animal
car	object	object/inanim
car-leasing	abstract	abstract/inanim
carabinier	person	person
carat	quantity	quantity/inanim
carbide-product	object	object/inanim
carbon	substance	substance/inanim
carcass	object	object/inanim
carcinologist	person	person
card	object	object/inanim
cardboard	substance	substance/inanim
cardinal	person	person
Cardinals	organization	organization
cardiologist	person	person
cards	object	object/plural
care	abstract	abstract/inanim
career	abstract	abstract
caregiver	person	person
caretaker	person	person
cargo	object	object/inanim
caribou	animal	animal
caricature	abstract	abstract/inanim
caricaturist	person	person
carillon	object	object/inanim
Carnival	event	event
carnivore	animal	animal
carnivore	person	person
carny	person	person
carpenter	person	person
carpet	object	object/inanim
carpetbagger	person	person
carpeting	abstract	abstract/inanim
carrier	organization	organization
carrier	person	person
carrot	plant	food/inanim
cars	object	object/plural
cart	object	object
cartel	organization	organization
cartographer	person	person
carton	object	object/inanim
cartoon	object	object/inanim
cartoonist	person	person
cartridge	object	object/inanim
cartwright	person	person
carvings	quantity	quantity/plural
cascade	abstract	abstract/inanim
case	abstract	abstract/inanim
cases	object	object
caseworker	person	person
cash	object	object/inanim
cashier	person	person
casino	organization	organization
casino	place	place/inanim
casket	object	object/inanim
Casnondelibreaten	abstract	abstract
cassette	object	object/inanim
cast	abstract	abstract
castellan	person	person
cat	animal	animal
Catalan	person	person
catechist	person	person
caterer	person	person
caterers	place	place
cathedral	object	object/inanim
Cathedral	place	place
cattle	animal	animal
causes	abstract	abstract
causes	abstract	abstract/plural
Cavalcade	event	event
Cavaliers	organization	organization
cavalry	person	person
cavalryman	person	person
cavapoo	animal	animal
cave	place	place/inanim
caver	person	person
caves	event	event/plural
CBC	abstract	abstract
CBC.ca	organization	organization
CC-BY-SA-NC	abstract	abstract
CEI	organization	organization
ceiling	object	object/inanim
celebrities	person	person
celebutante	person	person
cell	object	object/inanim
cell	place	place/inanim
cellist	person	person
cenote	place	place/inanim
census	event	event/inanim
center	place	place/inanim
centers	place	place/plural
centre	place	place/inanim
centuries	time	time/plural
century	time	time/inanim
CEO	person	person
ceo	person	person
ceramic	substance	substance
ceramist	person	person
Cereal	object	object
cereal	object	object/inanim
ceremony	event	event
certainty	abstract	abstract/inanim
Chadian	person	person
chairman	person	person
chairwoman	person	person/female
chalk	object	object/inanim
Challenger	object	object
chamber-maid	person	person
chamberlain	person	person
chameleon	animal	animal
chamois	animal	animal
Championship	event	event
championship	event	event/inanim
chance	abstract	abstract/inanim
chances	abstract	abstract/plural
change	abstract	abstract
Change	organization	organization
changes	abstract	abstract/plural
chansonnier	person	person
chantilly-tiffany	animal	animal
chaplain	person	person
chapmen	person	person
character	abstract	abstract
character	person	person
characters	abstract	abstract/plural
characters	person	person
charge	abstract	abstract/inanim
charges	object	object/plural
charioteer	person	person
charities	organization	organization
charm	abstract	abstract
charms	abstract	abstract/plural
chart	object	object
charwoman	person	person
chaser	person	person
chasers	person	person/plural
chasers	person	person/plural
Chathams	object	object/plural
chauffeur	person	person
cheating	event	event/inanim
check	event	event/inanim
check	object	object/inanim
checkpoint	place	place/inanim
cheerleader	person	person
cheesecloth	object	object
cheetah	animal	animal
chef	person	person
chemicals	object	object
chemist	person	person
chemistry	abstract	abstract
chicken	animal	animal
chickens	animal	animal/plural
chihuahua	animal	animal
child	person	person
children	person	person
Chilean	person	person
chimpanzee	animal	animal
China	place	place
Chinatown	place	place
chinchilla	animal	animal
Chinese	abstract	abstract
Chinese	person	person
chinook	animal	animal
chipmunk	animal	animal
chippiparai	animal	animal
chiropractor	person	person
chocolate	substance	substance
chocolatier	person	person
choice	abstract	abstract
choices	abstract	abstract
choose	person	person/plural
choreographer	person	person
christianity	organization	organization/inanim
Chrome	object	object
chronicler	person	person
chrysotile	substance	substance
Church	organization	organization
church	place	place/inanim
churchman	person	person
chute	object	object/inanim
chutes	object	object/plural
cicada	animal	animal/inanim
cider	substance	substance
cigarette	object	object/inanim
cinematographer	person	person
Cinnamon	object	object
cinnamon	object	object/inanim
circle	abstract	abstract
Circle	organization	organization
circumstances	abstract	abstract
circus	organization	organization
circus	place	place
citizens	person	person/plural
citral	plant	plant
City	place	place
city	place	place/inanim
civil	abstract	abstract/inanim
civility	abstract	abstract
civilization	organization	organization/inanim
claim	abstract	abstract/inanim
claims	abstract	abstract/plural
clam	animal	animal
clarinetist	person	person
class	abstract	abstract
classicist	person	person
cleaner	person	person
cleanup	abstract	abstract
clergy	person	person
cleric	person	person
clerk	person	person
Cleveland	place	place
click	event	event/inanim
Cliffs	place	place
climate	abstract	abstract
climatologist	person	person
climber	person	person
clinic	place	place/inanim
clinician	person	person
clockmaker	person	person
clones	abstract	abstract
Close	person	person
close	time	time
cloth	object	object
clothes	object	object
clothier	person	person
clothing	object	object
clown	person	person
club	object	object/inanim
club	organization	organization/inanim
club	place	place/inanim
cm	quantity	quantity/plural
cm.	quantity	quantity/plural
co-founder	person	person
co-producer	person	person
coach	person	person
coachman	person	person
coast	place	place/inanim
coastline	place	place/inanim
coauthor	person	person
COBOL	abstract	abstract/inanim
cobra	animal	animal
cockapoo	animal	animal
cockatiel	animal	animal
cockroach	animal	animal
cocktail	substance	substance/inanim
cocktails	object	object
cocoa	substance	substance
code	abstract	abstract/inanim
Code	object	object
coffeehouses	place	place
cofferer	person	person
coin	object	object/inanim
coiner	person	person
cold	abstract	abstract
collaboration	abstract	abstract/inanim
collaboration	event	event
collapse	event	event/inanim
collarbone	object	object/inanim
colleagues	person	person
collection	abstract	abstract
Collections	abstract	abstract
collections	abstract	abstract/plural
college	organization	organization
college	place	place
colleges	organization	organization/plural
Colombian	person	person
colonel	person	person
colonies	place	place/plural
color	abstract	abstract
colorist	person	person
colors	abstract	abstract
colt	animal	animal
Columbia	object	object
columbidae	animal	animal
column	object	object/inanim
columnist	person	person
combai	animal	animal
combination	abstract	abstract
Comeback	event	event
comeback	event	event/inanim
comedian	person	person
comedy	abstract	abstract/inanim
comics	abstract	abstract/plural
command	abstract	abstract/inanim
commander	person	person
commanders	person	person/plural
commentator	person	person
comments	abstract	abstract/plural
commissar	person	person
commission	organization	organization/inanim
commitments	abstract	abstract/plural
Committee	organization	organization
commodore	person	person
commoner	person	person
Commons	organization	organization
commonwealth	place	place
communication	abstract	abstract/inanim
communique	abstract	abstract/inanim
communities	organization	organization/plural
community	organization	organization
Comorian	person	person
companies	organization	company/plural
companion	person	person
companions	person	person/plural
company	organization	company
comparisons	abstract	abstract
compasssmith	person	person
compatibility	abstract	abstract
compete	abstract	abstract
competition	abstract	abstract/inanim
competition	organization	organization/inanim
competitions	event	event/plural
compiler	abstract	abstract/inanim
Complex	place	place
complication	abstract	abstract
compliments	event	event/plural
composer	person	person
composition	abstract	abstract
compositor	person	person
compound	abstract	abstract/inanim
compound	place	place/inanim
compound	plant	plant
compound	substance	substance/inanim
computer	object	object/inanim
computers	organization	organization
concentration	animal	animal
concentrations	animal	animal/plural
concept	abstract	abstract
concern	abstract	abstract/inanim
concertmaster	person	person
concerts	event	event
concierge	person	person
conclusion	event	event
concrete	substance	substance/inanim
condemnation	abstract	abstract
condition	abstract	abstract
conditions	abstract	abstract/plural
condottiere	person	person
conductor	person	person
conference	event	event/inanim
conferencier	person	person
confidence	abstract	abstract/inanim
conflict	event	event
conflicts	abstract	abstract/plural
confrontation	event	event/inanim
congestion	abstract	abstract/inanim
Congolese	person	person
connections	abstract	abstract/plural
connector	object	object/inanim
connoisseur	person	person
connotation	abstract	abstract
conquistador	person	person
conquistadors	place	place/plural
consensus	abstract	abstract
conservationist	person	person
conservator-restorer	person	person
consort	person	person
conspiracy	abstract	abstract/inanim
constable	person	person
constitution	object	object/inanim
constraints	abstract	abstract
construction	place	place/inanim
consul	person	person
consulate	abstract	abstract/inanim
consultant	person	person
consultor	person	person
consumerism	abstract	abstract/inanim
consumption	abstract	abstract
contact	abstract	abstract/inanim
contact	person	person
container	object	object
containers	object	object
contamination	abstract	abstract
content	abstract	abstract
contents	object	object
contest	event	event/inanim
context	abstract	abstract/inanim
contexts	abstract	abstract/plural
continents	place	place/plural
continuation	abstract	abstract/inanim
contortionist	person	person
contrasts	abstract	abstract/plural
control	abstract	abstract/inanim
controller	object	object/inanim
controller	person	person
controls	event	event/plural
Convention	event	event
conversation	abstract	abstract/inanim
conversations	event	event
conveyancer	person	person
cook	person	person
cookie	object	object
coonhound	animal	animal
cooper	person	person
cop	person	person
copenhagen	abstract	abstract/inanim
coppersmith	person	person
copy	object	object/inanim
copyist	person	person
copyright	abstract	abstract
copywriter	person	person
core	place	place
corgi-chihuahua	animal	animal
cormorant	animal	animal
corn	plant	plant
corner	place	place/inanim
cornerman	person	person
cornetist	person	person
Cornyn	person	person
coroner	person	person
corpora	abstract	abstract/inanim
corporation	organization	organization/inanim
corporatism	abstract	abstract
corpus	abstract	abstract/inanim
corrector	person	person
corsetmaker	person	person
corvus	animal	animal
cosmetics	person	person
cosmetologist	person	person
cosmologist	person	person
cossack	person	person
cost	quantity	quantity/inanim
costermonger	person	person
costs	abstract	abstract/plural
costumer	person	person
cotton	plant	plant
cougar	animal	animal
councillor	person	person
counsel	organization	organization/inanim
counsellor	person	person
counselor	person	person
Countdown	place	place
counter	place	place
counteractions	abstract	abstract/plural
counterpart	abstract	abstract
counterpart	person	person
countries	place	place/plural
country	place	place
County	place	place
couple	time	time/inanim
courier	person	person
course	abstract	abstract/inanim
courses	place	place
court	organization	organization
courtesan	person	person
courtier	person	person
courts	organization	organization/plural
couscous	substance	food/inanim
couturier	person	person
covariation	abstract	abstract
cover	abstract	abstract
cover	object	object
coverage	abstract	abstract/inanim
covers	abstract	abstract/plural
cowboy	person	person
coxswain	person	person
coyote	animal	animal
crab	animal	animal
crane	animal	animal
cranium	object	object/inanim
cream	place	place
creation	substance	substance
creations	object	object
creators	person	person/plural
creature	animal	animal
creature	person	person
creep	person	person
crew	person	person
crewman	person	person
cricketeer	person	person
cricketer	person	person
crime	event	event/inanim
criminal	person	person
criminologist	person	person
crisis	abstract	abstract/inanim
criterion	abstract	abstract/inanim
critic	person	person
criticism	abstract	abstract/inanim
Critics	person	person
critics	person	person/plural
Croatian	person	person
crocidolite	substance	substance
crocodile	animal	animal
cronista	person	person
cronyism	abstract	abstract
crop	plant	plant
crops	plant	plant
crops-damaging	plant	plant
crossbowyer	person	person
cruel	event	event
cruise	object	object/inanim
Cruise	person	person
crush	event	event/inanim
cryptographer	person	person
cryptologist	person	person
cryptozoologist	person	person
crystallographer	person	person
cto	person	person
Cuban	person	person
cuc	quantity	quantity/inanim
CUC	quantity	quantity/plural
Cuccinelli	person	person
cuillerer	person	person
cuisine	abstract	abstract
culture	abstract	abstract
Cup	event	event
cupcake	object	object
cupcakes	object	object
cupcakes	object	object/plural
Cups	event	event
cups	place	place/inanim
curator	person	person
curiosity	abstract	abstract/inanim
curler	person	person
currier	person	person
custodian	person	person
customer	person	person
customers	person	person
customs	object	object
customs	organization	organization/plural
cutman	person	person
cutting	plant	plant/inanim
cuttings	plant	plant/plural
cuttings	plant	plant/plural
cyberneticist	person	person
cycle	abstract	abstract
cycles	event	event
cyclone	event	event/inanim
cyclones	event	event/plural
cyclones	event	event/plural
Cypriot	person	person
cytogeneticist	person	person
Czech	person	person
dachshund	animal	animal
dad	person	person/male
daddy	person	person/male
Daily	organization	organization/inanim
daimyo	person	person
dairymaid	person	person
Dallas	place	place
dalmatian	animal	animal
Daly	person	person
damage	abstract	abstract
damchi	animal	animal
dance	abstract	abstract
dancer	person	person
Dane	person	person
data	abstract	abstract/inanim
database	object	object
datajournalist	person	person
date	time	time
daughter	person	person/female
day	time	time-unit
dayan	person	person
days	time	time-unit/plural
dD	abstract	abstract
deacon	person	person
deal	abstract	abstract
dealer	person	person
death	event	event
deaths	event	event/plural
debate	abstract	abstract/inanim
debate	event	event/inanim
debates	abstract	abstract/plural
Dec.	time	time-unit/inanim
decade	time	time
decades	time	time
December	time	time-unit/inanim
decision	abstract	abstract
decisions	abstract	abstract/plural
declares	event	event
decline	event	event/inanim
decommissioning	event	event
decrease	event	event/inanim
dedication	abstract	abstract/inanim
deejay	person	person
deer	animal	animal
defector	person	person
defectors	person	person/plural
defendant	person	person
defender	person	person
defense	abstract	abstract/inanim
definition	event	event/inanim
defterdar	person	person
degree	quantity	quantity/inanim
degu	animal	animal
deities	abstract	abstract
deity	abstract	abstract/inanim
deli	place	place
delicious	quantity	quantity
delivery	abstract	abstract/inanim
demand	abstract	abstract
demise	event	event/inanim
demo	abstract	abstract/inanim
democracy	abstract	abstract/inanim
Democrats	person	person
demographer	person	person
demolitionist	person	person
denomination	organization	organization
dentist	person	person
denunciation	abstract	abstract/inanim
Department	organization	organization
department	organization	organization/inanim
departure	event	event/inanim
departures	event	event/plural
deployment	event	event/inanim
depression	event	event/inanim
deputies	person	person/plural
dermatologist	person	person
descendants	person	person/plural
design	abstract	abstract/inanim
designer	person	person
designs	abstract	abstract/plural
desire	person	person
destination	place	place/inanim
destroyer	object	object/inanim
destroyer	person	person
destruction	event	event/inanim
detail	abstract	abstract/inanim
detailhandler	person	person
details	abstract	abstract/plural
detective	person	person
detergent	substance	substance
developers	person	person
development	abstract	abstract
development	place	place
device	object	object/inanim
dhalang	person	person
dialect	abstract	abstract/inanim
diamantaire	person	person
diaper	object	object
diarist	person	person
dictionary	object	object
didgeridooist	person	person
diet	event	event
dietitian	person	person
difference	abstract	abstract/plural
difficulties	abstract	abstract
digerati	person	person
digits	event	event
dingo	animal	animal
dining	place	place
dinner	event	event/inanim
dioxide	abstract	abstract
diplomat	person	person
direction	abstract	abstract/inanim
director	person	person
disability	abstract	abstract/inanim
disadvantages	abstract	abstract
disaster	event	event/inanim
disciple	person	person
discipline	abstract	abstract/inanim
discipline	abstract	abstract/inanim
discomfort	abstract	abstract/inanim
discovery	object	object
discussion	abstract	abstract/inanim
discussions	abstract	abstract/plural
dishes	abstract	abstract
dishwasher	object	object
disk	object	object/inanim
dispatcher	person	person
displayed	place	place
displays	object	object
distance	abstract	abstract/inanim
distances	quantity	quantity/plural
distiller	person	person
distribution	abstract	abstract/inanim
District	place	place
districts	place	place/plural
divemaster	person	person
diver	person	person
divers	person	person/plural
diversity	abstract	abstract
diving	object	object/inanim
dj	person	person
DNA	abstract	abstract
dna	substance	substance/inanim
doctorate	abstract	abstract/inanim
document	object	object/inanim
documentalist	person	person
documentation	abstract	abstract
documents	object	object
dog	animal	animal
dogcatcher	person	person
dollar	quantity	quantity/inanim
dollars	quantity	quantity/plural
domain	place	place/inanim
dominance	abstract	abstract/inanim
dominatrix	person	person
Dominican	person	person
donated	person	person/plural
donation	abstract	abstract
donations	object	object/plural
donkey	animal	animal
donors	person	person
don\'ts	event	event
don\'ts	event	event/plural
door	object	object/inanim
doors	place	place/plural
dorgi	animal	animal
dormouse	animal	animal
dos	abstract	abstract/plural
doshu	person	person
doula	person	person
down	abstract	abstract
downtown	place	place
doxographer	person	person
dozen	quantity	quantity
dozens	object	object/plural
drafter	person	person
draftsman	person	person
dragoman	person	person
dragon	animal	animal
dragoon	person	person
drainage	event	event/inanim
dramaturge	person	person
dramaturgist	person	person
draws	abstract	abstract
drayman	person	person
dress	object	object
dresser	person	person
dresses	object	object
dressing	abstract	abstract
dressmaker	person	person
drever	animal	animal
driller	person	person
Drink	abstract	abstract
drink	object	object
drink	substance	substance
drive	event	event/inanim
driver	person	person
drives	object	object/plural
dromedary	animal	animal
drone	object	object/inanim
droughts	event	event
drover	person	person
druid	person	person
drummer	person	person
dryer	object	object
drywaller	person	person
dubber	person	person
dubbing	person	person
duchess	person	person
duck	animal	animal
Dunbar	person	person
dunker	animal	animal
durability	abstract	abstract
Duran	organization	organization
Durham	place	place
during	time	time
Dutch	person	person
duties	abstract	abstract/plural
duty	abstract	abstract/inanim
e-mail	abstract	abstract
e-tutor	person	person
each	abstract	abstract
eagle	animal	animal
earlier	time	time
early-Polynesians	person	person
earthquake	event	event
earthquakes	event	event
easier	object	object
ecologist	person	person
economics	abstract	abstract
economist	person	person
economy	abstract	abstract
ecosystem	abstract	abstract
Ecuadorian	person	person
edge	abstract	abstract/inanim
edges	place	place/plural
Edgewater	place	place
edit	event	event/inanim
editor	person	person
editors	person	person
educationalist	person	person
educator	person	person
eel	animal	animal
effect	abstract	abstract
effectiveness	abstract	abstract
effects	abstract	abstract
effort	abstract	abstract
efforts	event	event
eggs	object	object
Egyptian	person	person
egyptologist	person	person
eHow	place	place
eighteen	time	time
either	abstract	abstract
elder	person	person
elderly	person	person/plural
election	event	event
electrician	person	person
electron	substance	substance/inanim
electrons	substance	substance/plural
element	abstract	abstract
Elements	abstract	abstract
elements	abstract	abstract/plural
elephants	animal	animal/plural
elites	substance	substance/plural
elk	animal	animal
elo	animal	animal
email	abstract	abstract/inanim
emailing	person	person
embassy	place	place/inanim
embroiderer	person	person
Emirati	person	person
emission	event	event/inanim
emissions	abstract	abstract
emperor	person	person/male
employee	person	person
employees	person	person
employment	abstract	abstract/inanim
empty	object	object
encounter	event	event/inanim
end	event	event
endeavor	place	place/inanim
Endeavour	object	object
ending	abstract	abstract/inanim
endocrinologist	person	person
endodontist	person	person
enemy	organization	organization/inanim
energy	abstract	abstract
engine	object	object/inanim
engineer	person	person
engines	object	object
England	place	place
English	abstract	abstract
Englishman	person	person
Englishmen	person	person
Englishwoman	person	person
Englishwomen	person	person
engraver	person	person
enologist	person	person
Enterprise	object	object
entertainer	person	person
entertainment	abstract	abstract
entomologist	person	person
entrance	place	place
entremetteuse	person	person
entrepreneur	person	person
entry	place	place
envelope	object	object/inanim
environment	place	place
environmentalist	person	person
environments	place	place/plural
enzymologist	person	person
epidemiologist	person	person
epigrapher	person	person
episode	abstract	abstract
epistemologist	person	person
equestrian	person	person
equidae	animal	animal
equipment	object	object
era	time	time
Erie	place	place
Eritrean	person	person
esotericism	person	person
essayist	person	person
essence	abstract	abstract/inanim
essentials	object	object
establishment	place	place/inanim
establishments	place	place
esthetician	person	person
estimates	abstract	abstract/plural
Estonian	person	person
ethicist	person	person
Ethiopian	person	person
ethnobotanist	person	person
ethnographer	person	person
ethnologist	person	person
ethnomusicologist	person	person
ethologist	person	person
etudiante	person	person
etymologist	person	person
euphoniumist	person	person
eurasier	animal	animal
Eureka	place	place
eurohound	animal	animal
euros	quantity	quantity/plural
evacuation	event	event/inanim
evacuations	event	event/plural
evangelist	person	person
Evans	person	person
Evanston	place	place
Evansville	place	place
evaporation	abstract	abstract/inanim
evening	object	object
evenings	time	time/plural
event	abstract	abstract/inanim
event	event	event
event	event	event/inanim
events	event	event
everyone	person	person
everything	object	object
everywhere	place	place
evil	abstract	abstract
evolution	abstract	abstract
exaggerated	abstract	abstract
exaggeration	abstract	abstract/inanim
example	abstract	abstract
examples	abstract	abstract
excavations	event	event/plural
exception	abstract	abstract/inanim
exchange	organization	organization/inanim
excuse	abstract	abstract/inanim
executioner	person	person
executive	person	person
exercise	abstract	abstract/inanim
exercise	event	event/inanim
exhibit	event	event
exhibited	event	event
exhibition	event	event
exhibitionist	person	person
exhibits	event	event
exile	person	person
existence	abstract	abstract/inanim
exodontist	person	person
exoplanetologist	person	person
expat	person	person
expatriate	person	person
expectation	abstract	abstract/inanim
expectations	abstract	abstract/plural
expense	abstract	abstract/inanim
experience	abstract	abstract
Experience	place	place
experiences	abstract	abstract
experiment	event	event/inanim
experimenter	person	person
expert	person	person
experts	person	person/plural
explorer	abstract	abstract
Explorer	object	object
explorer	person	person
explorers	person	person/plural
export	abstract	abstract/inanim
exposure	abstract	abstract
expressman	person	person
extension	abstract	abstract/inanim
extent	abstract	abstract
exterminator	person	person
extra	person	person
extract	substance	substance
extremism	abstract	abstract
extremist	person	person
eye	object	object/inanim
eyes	object	object/plural
fabricator	person	person
face	object	object
faces	object	object/plural
facilities	place	place
fact	abstract	abstract
factor	abstract	abstract/inanim
Factory	place	place
factory	place	place/inanim
failure	abstract	abstract
fainting	event	event
faith	abstract	abstract
falcon	animal	animal
fall	time	time/inanim
fallout	substance	substance
fame	abstract	abstract/inanim
family	person	person
fan	object	object/inanim
fan	person	person
fans	person	person
farm	place	place/inanim
farmer	person	person
farmers	person	person/plural
farming	object	object/inanim
farmworker	person	person
Faroese	person	person
farrier	person	person
fascination	abstract	abstract
fashion	abstract	abstract
fasteners	object	object
fatalities	abstract	abstract/plural
father	person	person
fear	abstract	abstract
feat	event	event
features	abstract	abstract
Feb.	time	time-unit/inanim
February	time	time-unit/inanim
feds	person	person/plural
fee	abstract	abstract/inanim
feedback	abstract	abstract/inanim
feeling	abstract	abstract
fees	abstract	abstract/plural
feet	object	object/plural
feldsher	person	person
felidae	animal	animal
fellmonger	person	person
fellow	person	person
feltmaker	person	person
fence	person	person
ferret	animal	animal
ferry	object	object
fertilizer	object	object/inanim
festival	event	event
festivals	event	event/plural
festivals	event	event/plural
few	object	object
fewer	quantity	quantity
FFFF	event	event
fiddler	person	person
field	abstract	abstract/inanim
field	place	place/inanim
fields	abstract	abstract
fight	event	event/inanim
fighter	person	person
figure	person	person
figures	quantity	quantity/plural
Fijian	person	person
file	object	object/inanim
files	object	object/plural
Filipino	person	person
film	object	object
filmmaker	person	person
filter	object	object
finalists	abstract	abstract/plural
finance	abstract	abstract
financier	person	person
financing	abstract	abstract/inanim
finch	animal	animal
findings	abstract	abstract
findings	abstract	abstract/plural
fine	abstract	abstract/inanim
finger	person	person
Finkelstein	person	person
Finn	person	person
fire	abstract	abstract/inanim
firearm	object	object/inanim
fireater	person	person
firefighter	person	person
Firefox	object	object
fireman	person	person
fireworks	event	event
firm	organization	company
fish	animal	animal
fisherman	person	person
fishermen	person	person/plural
fishing	object	object/inanim
fishmonger	person	person
fixing	event	event/inanim
flag	object	object/inanim
flagman	person	person
flakes	substance	substance/plural
flamingo	animal	animal
flash	object	object
flats	object	object
flatulist	person	person
flavor	abstract	abstract
flavor(s)	abstract	abstract
flavoring	event	event
flavorist	person	person
flavors	abstract	abstract
flavour	abstract	abstract
flaws	abstract	abstract
fleet	object	object
flight	event	event
flight-adjutant	person	person
flights	event	event/plural
flirting	event	event
flmi	person	person
flooding	event	event/inanim
floods	event	event
floor	place	place/inanim
florist	person	person
flour	substance	substance
flow	abstract	abstract
flower	plant	plant
flowers	plant	plant/plural
flowers	plant	plant/plural
fluffer	person	person
fluid	substance	substance
flutist	person	person
foa	animal	animal
foal	animal	animal
fodder	object	object/inanim
folk	abstract	abstract/inanim
folklorist	person	person
folks	person	person
follow	event	event
food	substance	substance
foodies	person	person
footage	abstract	abstract
football	abstract	abstract/inanim
footman	person	person
forager	person	person
force	abstract	abstract/inanim
forecast	abstract	abstract/inanim
forecasts	abstract	abstract/plural
foreigners	person	person
foreman	person	person
forest	place	place/inanim
forester	person	person
form	abstract	abstract
formalin	substance	substance
format	abstract	abstract
fortress	place	place/inanim
fortune	abstract	abstract/inanim
forum	event	event/inanim
found	abstract	abstract
foundation	organization	organization
founder	person	person
fox	animal	animal
Fox	place	place
Franciscans	person	person
Francisco	place	place
Frank	person	person
freedom	abstract	abstract
freelancer	person	person
freeways	object	object/plural
freezer	object	object
French	abstract	abstract
French	person	person
friar	person	person
friction	object	object/inanim
Friday	time	time-unit
fridge	place	place
friend	person	person
friend(s)	person	person/plural
friends	person	person
friendships	abstract	abstract
frisbee	object	object/inanim
frog	animal	animal
frogman	person	person
From	time	time
front	place	place/inanim
frost	event	event
frosting	object	object
fruit	substance	substance
fugitive	person	person
fun	abstract	abstract/inanim
fungus	object	object/inanim
funnel	object	object/inanim
funnels	object	object/plural
furrier	person	person
fusilier	person	person
future	abstract	abstract
futures	abstract	abstract/plural
futurist	person	person
g	quantity	quantity
gaffer	person	person
gag	abstract	abstract/inanim
Gagarin	person	person
gal	person	person/female
gal	quantity	quantity/inanim
galleries	place	place
gallery	place	place
gallon	quantity	quantity/inanim
gals	person	person
gambist	person	person
gambler	person	person
game	abstract	abstract
gamekeeper	person	person
gamer	person	person
games	event	event
games	event	event/plural
gaming	abstract	abstract/inanim
gang	organization	organization/inanim
gangster	person	person
gap	abstract	abstract/inanim
gap	time	time
garb	object	object
garden	place	place
gardener	person	person
gardeners	person	person
gateway	place	place/inanim
gaucho	person	person
gazelle	animal	animal
gazette	substance	substance/inanim
geheimrat	person	person
geisha	person	person
gemcutter	person	person
gemsbok	animal	animal
genders	abstract	abstract
genealogist	person	person
general	person	person
General	person	person
generalissimo	person	person
generation	abstract	abstract/inanim
generations	abstract	abstract/plural
genes	abstract	abstract
geneticist	person	person
genius	abstract	abstract
genome	abstract	abstract
gensaku-sha	person	person
gentrification	abstract	abstract/inanim
geochemist	person	person
geodesist	person	person
geographer	person	person
geologist	person	person
geologists	person	person
geometer	person	person
geophysicist	person	person
Georgian	person	person
gerbil	animal	animal
German	abstract	abstract
German	person	person
germanist	person	person
gerontologist	person	person
Gerulaitis	person	person
Ghanaian	person	person
gharial	animal	animal
ghostwriter	person	person
gift	object	object
Gigaloader	object	object
gigolo	person	person
giraffe	animal	animal
girl	person	person/female
girlfriend	person	person/female
girls	person	person/plural
Gish	person	person
glaciologist	person	person
gladiator	person	person
glass	object	object
glassblower	person	person
glasses	object	object
glazier	person	person
Gliders	organization	organization
globe	object	object/inanim
Globe	plant	plant
globemaker	person	person
glove	object	object/inanim
glovemaker	person	person
gloves	object	object/plural
glow	abstract	abstract
glowstick	object	object/inanim
glowsticks	object	object/plural
glut	abstract	abstract
glycobiologist	person	person
GMT	time	time
gmt	time	time/inanim
gnp	abstract	abstract/inanim
goal	abstract	abstract/inanim
goalkeeper	person	person
goals	event	event
goat	animal	animal
goatherd	person	person
god	abstract	abstract/inanim
goddess	abstract	abstract/inanim
gods	abstract	abstract
goers	person	person
goldendoodle	animal	animal
goldsmith	person	person
golfer	person	person
gondolier	person	person
goods	object	object
goose	animal	animal
gorilla	animal	animal
governess	person	person
government	organization	organization/inanim
government	organization	organization/plural
governments	organization	organization/plural
governor	person	person
Governor	person	person
Governor(s)	person	person
governors	person	person
gov\'t	event	event/plural
gov\'t	organization	organization/inanim
gram	quantity	quantity/inanim
grammar	abstract	abstract
grammarian	person	person
gramps	person	person/male
grams	substance	substance/plural
Grand	place	place
grandfather	person	person/male
grandma	person	person/female
grandmother	person	person/female
grandpa	person	person/male
grant	abstract	abstract/inanim
grape	abstract	abstract
graphic	object	object/inanim
grass	place	place/inanim
grazier	person	person
Greek	person	person
Greeks	person	person
green	abstract	abstract
greengrocer	person	person
Greensboro	organization	organization
greensman	person	person
greeting	event	event
Gregoire	person	person
Grenadian	person	person
grenadier	person	person
greyhound	animal	animal
gridlock	event	event/inanim
grief	abstract	abstract/inanim
griot	person	person
grip	object	object
grip	person	person
grocer	person	person
groenendael	animal	animal
groom	person	person
groomer	person	person
ground	place	place/inanim
groundskeeper	person	person
group	abstract	abstract
groups	person	person/plural
growth	abstract	abstract/inanim
guanaco	animal	animal
guarantee	abstract	abstract/inanim
Guatemalan	person	person
guests	person	person/plural
guests	person	person/plural
Guianese	person	person
guide	object	object
guide	person	person
guidelines	abstract	abstract/inanim
Guinean	person	person
Guinean	person	person
guitarist	person	person
gull	animal	animal
gun	object	object
gunfighter	person	person
gunpowder	substance	substance/inanim
gunsmith	person	person
guru	person	person
Gustafon	person	person
guy	person	person/male
Guyanese	person	person
guys	person	person/plural
gymnast	person	person
gymterneter	person	person
gynecologist	person	person
haberdasher	person	person
habitat	place	place/inanim
hacker	person	person
Hackers	person	person
hackers	person	person/plural
hagfish	animal	animal
hairdresser	person	person
Haitian	person	person
Hajj	person	person/male
hall	abstract	abstract/inanim
Hall	place	place
halls	place	place
Halston	person	person
Hamill	person	person
hamiltonstövare	animal	animal
hampshire	abstract	abstract/inanim
hamster	animal	animal
hand	place	place/inanim
handle	quantity	quantity
handling	abstract	abstract
hands	object	object
handyman	person	person
hangar	place	place
Hanks	person	person
happening	event	event
happy	event	event
harbor	place	place/inanim
harbour	place	place
harbours	place	place/plural
hare	animal	animal
harm	abstract	abstract/inanim
harness	object	object/inanim
harpist	person	person
harpsichordist	person	person
harrier	animal	animal
hartebeest	animal	animal
harvests	event	event/plural
hatter	person	person
havanese	animal	animal
have	event	event
haven	place	place
having	event	event
hawk	animal	animal
hawker	person	person
Hawthorne	place	place
hayward	person	person
hazzan	person	person
head	object	object
head	person	person
headmaster	person	person
headquarters	place	place/inanim
heads	plant	plant
Heagle	person	person
Heald	person	person
HealthSpace	place	place
heartland	place	place/inanim
heat	substance	substance
heat-attributed	substance	substance
heaven	place	place
hebraist	person	person
hedgehog	animal	animal
height	quantity	quantity
heilpraktiker	person	person
helicopters	object	object/plural
help	abstract	abstract/inanim
helpmate	person	person
hematologist	person	person
hematopathology	person	person
henequen	plant	plant/inanim
hens	animal	animal/plural
Hera	person	person
Herald	organization	newspaper
herald	person	person
heraldry	person	person
herb	plant	plant
herbalist	person	person
herder	person	person
here	place	place
hermit	person	person
heron	animal	animal
herpetologist	person	person
Herrick	person	person
hetaira	person	person
hieromonk	person	person
highlights	place	place
highrise	place	place
highwayman	person	person
Hill	person	person
hill	place	place
hills	object	object
hip	abstract	abstract
hippopotamus	animal	animal
hipster	abstract	abstract
hiring	abstract	abstract
hispanist	person	person
historian	person	person
histories	abstract	abstract/plural
history	abstract	abstract
hit	abstract	abstract
hitman	person	person
hoaxes	abstract	abstract/plural
hobbies	object	object/plural
hobby	abstract	abstract
hobo	person	person
hockey	person	person
hold	abstract	abstract/inanim
holder	person	person
holders	object	object
holes	object	object
holiday	time	time
home	place	place
homebrewing	person	person
homemaking	person	person
homeopath	person	person
homepage	place	place
homes	place	place
homosexuality	abstract	abstract/inanim
Honduran	person	person
honeydew	object	object/inanim
hoops	object	object/plural
Hopper	person	person
hornet	animal	animal
hornist	person	person
horologist	person	person
horror	abstract	abstract
horrors	object	object/plural
horse	animal	animal
horticulturalist	person	person
horticulturist	person	person
hospital	place	place
host	person	person
hostler	person	person
hotel	place	place/inanim
hotels	place	place/plural
hour	time	time-unit/inanim
hours	time	time-unit/plural
house	place	place
houseboy	person	person
housekeeper	person	person
housemaster	person	person
houses	place	place
houseware	object	object
housing	abstract	abstract/inanim
Houston	place	place
hovawart	animal	animal
hr	quantity	quantity/inanim
hub	place	place
huebi	person	person
Huebi	person	person
humanitarian	person	person
humanity	person	person
humans	person	person/plural
hummingbird	animal	animal
humorist	person	person
humpbacks	animal	animal
Hungarian	person	person
huntaway	animal	animal
hunter	person	person
Huntsville	place	place
husband	person	person/male
husbandman	person	person
husbands	person	person/plural
hydraulist	person	person
hydrogen	substance	substance/inanim
hydrogeologist	person	person
hydrographer	person	person
hyena	animal	animal
hygenhund	animal	animal
hymnist	person	person
hymnology	person	person
hypnosis	event	event/inanim
hypnotherapist	person	person
hypnotist	person	person
hypnotized	abstract	abstract
i	place	place/inanim
i-Nick	object	object
ibex	animal	animal
ice	substance	substance
Icelandian	person	person
ichthyologist	person	person
ICI	abstract	abstract
icing	object	object
idea	abstract	abstract
ideas	abstract	abstract/plural
identification	abstract	abstract
identity	abstract	abstract/inanim
ideology	abstract	abstract/inanim
IE	object	object
IE6	object	object
iguana	animal	animal
Illinois	place	place
illusionist	person	person
illustrator	person	person
IM	abstract	abstract
im	event	event/inanim
image	object	object
images	object	object
imagination	abstract	abstract
imagineer	person	person
imam	person	person
immigrant	person	person
immigration	abstract	abstract/inanim
immobility	abstract	abstract/inanim
immunologist	person	person
impact	event	event/inanim
impacts	abstract	abstract
impala	animal	animal
imperfection	abstract	abstract
imperfections	abstract	abstract
impersonator	person	person
importance	abstract	abstract
impostor	person	person
impresario	person	person
impression	abstract	abstract
impressionist	person	person
imprisoned	event	event/inanim
improvement	abstract	abstract
improviser	person	person
IMU	abstract	abstract
in	place	place
Inc.	organization	organization/inanim
incentive	abstract	abstract
incentives	abstract	abstract/plural
inch	quantity	quantity/inanim
inches	quantity	quantity/plural
incident	event	event
incidents	event	event/plural
income	object	object/inanim
increases	event	event
Indian	person	person
Indians	organization	organization
individual	person	person
individuals	person	person
indologist	person	person
Indonesian	person	person
Indonesians	person	person/plural
industrialist	person	person
industriemechaniker	person	person
industry	abstract	abstract
inertia	abstract	abstract/inanim
inferiors	person	person
infielder	person	person
influence	abstract	abstract
influences	abstract	abstract
informant	person	person
informatica	person	person
information	abstract	abstract
infrastructure	abstract	abstract/inanim
Ingram	person	person
ingredients	substance	substance
inhabitants	person	person/plural
initiatives	abstract	abstract/plural
injuries	event	event/plural
injury	event	event/inanim
inker	person	person
innkeeper	person	person
input	abstract	abstract
insects	animal	animal/plural
insider	person	person
insides	quantity	quantity
inspection	event	event/inanim
inspector	person	person
installation	abstract	abstract/inanim
instance	person	person
Institute	organization	organization
institutions	organization	organization
instructions	abstract	abstract
instructor	person	person
instructors	person	person/plural
insurer	person	person
insurgency	organization	organization
insurgent	person	person
intake	event	event/inanim
intellectual	person	person
intelligence	abstract	abstract
intendant	person	person
interaction	abstract	abstract
interest	abstract	abstract
interests	abstract	abstract/plural
interface	abstract	abstract/inanim
Internet	abstract	abstract
internet	place	place/inanim
internist	person	person
internship	abstract	abstract/inanim
interpreter	person	person
interrogator	person	person
Interview	event	event
interview	event	event/inanim
inventor	person	person
investigation	abstract	abstract/inanim
investigator	person	person
investor	person	person
invitation	event	event
IQA	object	object/plural
Iranian	person	person
Iraqi	person	person
Irish	person	person
irishjacks	animal	animal
Irishman	person	person
Irishmen	person	person
Irishwoman	person	person
Irishwomen	person	person
ironmaster	person	person
ironmonger	person	person
ironworker	person	person
is	abstract	abstract
Island	place	place
island	place	place/inanim
islands	place	place
isle	place	place/inanim
israel	abstract	abstract/inanim
Israeli	person	person
issue	abstract	abstract
issues	abstract	abstract
it	time	time/plural
Italian	person	person
Italy	place	place
item	object	object
items	object	object
Ivoirian	person	person
jämthund	animal	animal
Jack	person	person
jackal	animal	animal
jackaroo	person	person
Jackson	person	person
jagdterrier	animal	animal
jaguar	animal	animal
jail	place	place/inanim
jailer	person	person
Jake	place	place
Jamaican	person	person
jams	event	event/plural
Jan.	time	time-unit/inanim
janitor	person	person
January	time	time-unit/inanim
Japanese	person	person
Japanese	person	person/plural
jargon	abstract	abstract/inanim
Jealousy	abstract	abstract
jealousy	abstract	abstract/inanim
jeans	object	object
jellyfish	animal	animal
jerboa	animal	animal
Jersey	place	place
jester	person	person
jeweler	person	person
jeweller	person	person
jezebel	abstract	abstract/inanim
JFK	place	place
job	abstract	abstract
jockey	person	person
John	person	person
joiner	person	person
joke	event	event/inanim
joke-telling	event	event
jokes	object	object/plural
jolt	event	event/inanim
jonangi	animal	animal
Jordanian	person	person
journal	object	object
journalist	person	person
journey	event	event
journeyman	person	person
JP	person	person
JSC	place	place
Jubilee	event	event
judge	person	person
judgement	event	event/inanim
jug	object	object
juggler	person	person
juice	substance	substance
July	time	time-unit/inanim
jump	event	event/inanim
jumper	person	person
junction	place	place/inanim
junctions	place	place/plural
June	time	time-unit/inanim
junk	object	object
junkyard	place	place
jurist	person	person
justiciar	person	person
kaikadi	animal	animal
kangaroo	animal	animal
kanni	animal	animal
kannushi	person	person
kapellmeister	person	person
karakachan	animal	animal
kar\u014d	person	person
kaymakam	person	person
Kazakh	person	person
KCNA	organization	organization
keep	event	event
keeper	place	place/inanim
keepers	person	person/plural
keeshond	animal	animal
Kennedy	place	place
Kenyan	person	person
keys	abstract	abstract
keytarist	person	person
khatib	person	person
Khincasnonbever	abstract	abstract
Khinssa	abstract	abstract
Khinssacasnondelibreatenibever	abstract	abstract
kickback	abstract	abstract/inanim
kid	person	person
Kids	person	person
kids	person	person/plural
kilometers	quantity	quantity/plural
kind	substance	substance
kinesiologist	person	person
kingdom	organization	organization/inanim
kinkajou	animal	animal
kintamani	animal	animal
kishu	animal	animal
kit	object	object/inanim
kits	object	object/plural
kitten	animal	animal
km	quantity	quantity/plural
knacker	person	person
knifegrinder	person	person
knifesmith	person	person
knight	person	person
knight-errant	person	person
knocker-up	person	person
Know	abstract	abstract
know	organization	organization
knowledge	abstract	abstract
koala	animal	animal
koi	animal	animal
komondor	animal	animal
kooikerhondje	animal	animal
koolie	animal	animal
Korean	person	person
Kosovar	person	person
Kosovite	person	person
KPA	organization	organization
kromfohrländer	animal	animal
KSC	place	place
kudu	animal	animal
Kurd	person	person
kuri	animal	animal
kuvasz	animal	animal
Kuwaiti	person	person
kyi-leo	animal	animal
Kyrgyz	person	person
löwchen	animal	animal
LA	place	place
lab	object	object/inanim
labor	abstract	abstract/inanim
laboratory	place	place
laborer	person	person
laborers	person	person
labour	abstract	abstract/inanim
lack	quantity	quantity
lackey	person	person
ladies	person	person/plural
lady-in-waiting	person	person
laekenois	animal	animal
laity	person	person
Lake	place	place
lakefront	place	place
lakes	place	place/plural
Lakeshore	place	place
lama	person	person
lamb	animal	animal
lamplighter	person	person
land	abstract	abstract
landfall	abstract	abstract/inanim
landholder	person	person
landlord	person	person
landscaper	person	person
landseer	animal	animal
landslides	event	event/plural
lane	place	place/inanim
lanes	place	place/plural
language	abstract	abstract
Language	object	object
languages	abstract	abstract
Lankan	person	person
Lao	person	person
lap	abstract	abstract
lapses	abstract	abstract
largest	object	object
lark	animal	animal
laryngologist	person	person
Latvian	person	person
laugh	abstract	abstract/inanim
launch	abstract	abstract
launchpads	place	place
law	abstract	abstract/inanim
lawbreakers	person	person/plural
lawman	person	person
laws	abstract	abstract
Lawsuits	abstract	abstract
lawyer	person	person
layman	person	person
leader	person	person
leadership	abstract	abstract
leadman	person	person
leadworker	person	person
leaf	plant	plant
learning	abstract	abstract/inanim
leaves	plant	plant
Lebanese	person	person
lector	person	person
lecturer	person	person
lee	place	place
left	abstract	abstract
leg	object	object/inanim
legacy	abstract	abstract
legend	abstract	abstract/inanim
legion	organization	organization/inanim
legislation	abstract	abstract/inanim
legislator	person	person
legislators	person	person
legislature	organization	organization
legs	object	object/plural
lehrer	person	person
lemur	animal	animal
length	quantity	quantity/inanim
leonberger	animal	animal
Leonean	person	person
Leonia	place	place
leopard	animal	animal
lepidopterist	person	person
leporids	animal	animal
letter	abstract	abstract
letter	object	object
letterer	person	person
letters	abstract	abstract
level	abstract	abstract
levels	abstract	abstract
lexicographer	person	person
Liberian	person	person
Libertarian	person	person
Libertarians	person	person
liberty	abstract	abstract
librarian	person	person
librettist	person	person
Libyan	person	person
License	abstract	abstract
license	object	object/inanim
licensee	person	person
lid	object	object
lids	object	object/plural
Liechtensteinian	person	person
lies	abstract	abstract/plural
lieutenant	person	person
life	abstract	abstract/inanim
lifecaster	person	person
lifeguard	person	person
lifehood	abstract	abstract/inanim
lifestyle	abstract	abstract/inanim
lifetime	abstract	abstract
lifetimes	time	time/plural
liftoff	event	event
liger	animal	animal
light	abstract	abstract
light	abstract	abstract/inanim
lights	abstract	abstract
lightworker	person	person
likes	abstract	abstract/plural
liliger	animal	animal
lime	abstract	abstract
limestone	substance	substance/inanim
limits	abstract	abstract
limner	person	person
line	place	place
lineman	person	person
lines	object	object/plural
linguist	person	person
lion	animal	animal
lipizzan	animal	animal
list	object	object
lists	abstract	abstract
liter	quantity	quantity
liters	quantity	quantity/plural
lithographer	person	person
Lithuanian	person	person
Live	place	place
lives	abstract	abstract/inanim
lizard	animal	animal
llama	animal	animal
llanero	person	person
loads	quantity	quantity/plural
lobby	place	place/inanim
lobbyist	person	person
lobster	animal	animal
local	person	person
localities	place	place
locals	person	person
location	place	place
locations	place	place
locksmith	person	person
lodge	place	place/inanim
logger	person	person
logician	person	person
London	place	place
look	abstract	abstract
loopholes	abstract	abstract/plural
loss	event	event
lot	abstract	abstract
lots	abstract	abstract/plural
lots	object	object
loudspeaker	object	object/inanim
loudspeakers	object	object/plural
Louis	place	place
louse	animal	animal
lovebird	animal	animal
Lucian	person	person
luck	abstract	abstract/inanim
luger	person	person
luggage	object	object/inanim
lull	abstract	abstract/inanim
lumberjack	person	person
lumbricidae	animal	animal
luminescence	abstract	abstract
luminol	substance	substance/inanim
lunch	event	event/inanim
lutenist	person	person
luthier	person	person
Luxembourgian	person	person
lynx	animal	animal
lyricist	person	person
macaque	animal	animal
Macedonian	person	person
Macedonian	person	person
machine	object	object
machines	object	object/plural
machineworker	person	person
machinist	person	person
macropodidae	animal	animal
mafioso	person	person
magasinier	person	person
magazine	organization	organization
magazines	object	object
Magazines	organization	organization
magic	abstract	abstract
Magic	place	place
magician	person	person
magicians	person	person
magistrate	person	person
magnate	person	person
magnification	quantity	quantity
magpie	animal	animal
mahout	person	person
maid	person	person
maids	person	person
mail	abstract	abstract/inanim
mainland	place	place/inanim
maintenance	abstract	abstract
maize	plant	plant
major	person	person
majordomo	person	person
majority	person	person
make	event	event
maker	organization	company/inanim
maker	person	person
Malagasy	person	person
Malawian	person	person
Malaysian	person	person
Maldivian	person	person
male-nurse	person	person
Malian	person	person
malinois	animal	animal
mallard	animal	animal
malls	place	place/plural
maltepoo	animal	animal
Maltese	person	person
mama	person	person/female
man	person	person/male
man-servant	person	person
management	organization	organization/inanim
management	person	person
manager	person	person
manatee	animal	animal
manciple	person	person
mandate	abstract	abstract/inanim
mandolinist	person	person
mandrill	animal	animal
manga	abstract	abstract
mangaka	person	person
manganese	substance	substance/inanim
Manhattan	place	place
maniacs	person	person/plural
manicurist	person	person
manner	abstract	abstract/inanim
mantero	person	person
mantids	animal	animal/plural
mantra	abstract	abstract/inanim
manual	object	object
manufacturer	organization	company/inanim
manufacturer	person	person
Manx	person	person
many	person	person
Many	place	place
map	object	object
Mapplethorpe	person	person
maps	object	object/plural
Mar.	time	time/inanim
marae	place	place/inanim
marbler	person	person
March	time	time-unit/inanim
mare	animal	animal
Marilyn	person	person
market	abstract	abstract/inanim
market	place	place/inanim
marketeer	person	person
marketer	person	person
marketing	person	person
markets	place	place
marks	abstract	abstract
marksman	person	person
marmoset	animal	animal
marquess	person	person
marriage	abstract	abstract
marten	animal	animal
Marv	person	person
mason	person	person
masseur	person	person
master	person	person
mastinaro	animal	animal
matbennett	person	person
material	abstract	abstract
materials	substance	substance
mathematician	person	person
matron	person	person
matter	event	event/inanim
Mauer	person	person
Maurer	person	person
Mauritian	person	person
May	time	time-unit/inanim
mayanist	person	person
mayo	substance	substance
mayonnaise	substance	substance
mayor	person	person
MC	person	person
McAuliffe	person	person
McDonald	person	person
McDonnell	person	person
McKenzie	person	person
me	abstract	abstract/plural
meals	object	object
meaning	abstract	abstract/inanim
measure	abstract	abstract
mecca	place	place/inanim
mechanic	person	person
mechanician	person	person
medalist	person	person
media	organization	organization/plural
mediator	person	person
medic	person	person
medicine	person	person
medicine	substance	substance/inanim
medium	object	object
meerkat	animal	animal
meeting	event	event/inanim
meetups	event	event
Melbourne	event	event
member	person	person
members	person	person/plural
members	person	person/plural
memoirist	person	person
memory	object	object/inanim
Men	person	person
men	person	person/plural
menin	person	person
mentality	abstract	abstract
mercenary	person	person
mercer	person	person
merchant	person	person
Merritt	place	place
mesmerist	person	person
message	object	object
messenger-at-arms	person	person
Messina	person	person
metallurgist	person	person
metalsmith	person	person
meteorologist	person	person
meter	object	object
Method	abstract	abstract
method	substance	substance/inanim
methods	abstract	abstract
metres	place	place
metro.us	organization	organization
metrologist	person	person
Mets	organization	organization
Mexican	person	person
Mexico	place	place
mft	person	person
microbiologist	person	person
MicroMega	organization	organization
microscope	object	object
Microsoft	organization	organization
microtome	object	object
middle	place	place/inanim
midnight	time	time/inanim
midwife	person	person
migrant	person	person
migrants	person	person/plural
migration	abstract	abstract
migration	event	event
miles	abstract	abstract
militaries	organization	organization/plural
military	organization	organization
militia	organization	organization
milk	substance	substance
milkmaid	person	person
mill	place	place/inanim
miller	person	person
milliliters	substance	substance/plural
millions	person	person
millwright	person	person
mind	abstract	abstract
miner	person	person
mineralogist	person	person
miners	person	person/plural
mines	object	object/plural
mining	place	place/inanim
minister	person	person
Ministry	organization	organization
mink	animal	animal
minnow	animal	animal
minority	person	person
minstrel	person	person
minute	time	time-unit/inanim
minutes	time	time-unit/plural
misconception	abstract	abstract
mishandling	abstract	abstract
mission	event	event
missionary	person	person
missions	event	event/plural
mistake	object	object/inanim
mistakes	abstract	abstract
mistresses	person	person
mix	abstract	abstract
mixer	object	object
mixture	substance	substance
ml	quantity	quantity
MMPI	object	object
mobiles	object	object
mode	abstract	abstract/inanim
model	abstract	abstract
model	person	person
modeler	person	person
modelmaker	person	person
modern	place	place
modernity	abstract	abstract/inanim
moestiek	animal	animal
mogul	person	person
mohel	person	person
moisture	substance	substance/inanim
mold	plant	plant
moldmaker	person	person
Moldovan	person	person
mole	animal	animal
molecatcher	person	person
molosser	animal	animal
molossus	animal	animal
mom	person	person/female
moment	time	time
Moments	event	event
mommy	person	person/female
money	object	object
moneylender	person	person
Mongolian	person	person
mongoose	animal	animal
mongrel	animal	animal
moniker	abstract	abstract
monk	person	person
monkey	animal	animal
monks	person	person
monks	person	person/plural
monologist	person	person
montage	abstract	abstract
Montenegrin	person	person
month	time	time-unit/inanim
months	time	time-unit/plural
monument	object	object/inanim
moose	animal	animal
moratorium	event	event/inanim
more	abstract	abstract
morkie	animal	animal
morning	time	time
mornings	time	time/plural
Moroccan	person	person
morphology	person	person
mortgager	person	person
mortician	person	person
mosquito	animal	animal
moth	animal	animal
mother	person	person
mother	person	person/female
motherboard	object	object/inanim
Motion	organization	organization
motives	abstract	abstract/plural
motor	object	object/inanim
motorist	person	person
motorways	place	place/plural
mountaineer	person	person
mountains	object	object/plural
mouse	animal	animal
mouth	place	place
movement	abstract	abstract
movie	abstract	abstract/inanim
movies	abstract	abstract
moving	event	event
mp	person	person
MP	person	person
MSN	abstract	abstract
muckraker	person	person
mucuchies	animal	animal
mudi	animal	animal
muezzin	person	person
mufti	person	person
muggin	animal	animal
muggle	person	person
muggles	person	person/plural
mule	animal	animal
multi-instrumentalist	person	person
multireedist	person	person
mum	person	person/female
municipalities	organization	organization/plural
municipality	place	place/inanim
muralist	person	person
Museum	place	place
museum	place	place/inanim
museums	place	place
music	abstract	abstract
musician	person	person
musicians	person	person
musicologist	person	person
muskox	animal	animal
muskrat	animal	animal
muslin	object	object
mussel	animal	animal
mustang	animal	animal
mxn	quantity	quantity/inanim
mycologist	person	person
myself	person	person
négociant	person	person
nagarvadhu	person	person
nailist	person	person
name	abstract	abstract
names	abstract	abstract
names	abstract	abstract/plural
Namibian	person	person
nanny	person	person
narrator	person	person
NASA	organization	organization
nation	place	place
nationalities	abstract	abstract/plural
nationalization	abstract	abstract
nations	place	place/plural
natives	person	person
naturalist	person	person
nature	abstract	abstract
navigator	person	person
navy	organization	organization/inanim
NBC	organization	organization
need	abstract	abstract
needleworker	person	person
needs	abstract	abstract
negotiator	person	person
Neiafu	place	place
neighbor	person	person
neighborhood	place	place
neighborhoods	place	place
nematocysts	object	object
neologism	abstract	abstract/inanim
Nepalese	person	person
nephrologist	person	person
nest	place	place/inanim
nests	object	object/plural
net	place	place
Netherlands	place	place
netting	object	object/inanim
network	abstract	abstract/inanim
networks	place	place/plural
neurobiologist	person	person
neuroendocrinologist	person	person
neurologist	person	person
neurophysiologist	person	person
neuropsychologist	person	person
neuroroboticist	person	person
neuroscientist	person	person
neurosurgeon	person	person
neurosurgery	person	person
News	organization	organization
news	organization	organization/inanim
newscaster	person	person
newspaper	organization	organization
newspapers	object	object
newsprint	object	object
newsreader	person	person
newt	animal	animal
Newton	person	person
next	time	time
Nicaraguan	person	person
nickname	abstract	abstract
Nigerian	person	person
Nigerien	person	person
night	time	time
nightclubs	place	place
ninja	person	person
NJ	place	place
nobility	organization	organization/inanim
nobleman	person	person/male
noblewoman	person	person/female
nobody	person	person
nomination	abstract	abstract/inanim
nominee	person	person
nominees	person	person
non-locals	person	person
non-profit	organization	organization
nonprofit	organization	organization
nonsense	object	object/inanim
norrbottenspets	animal	animal
north	place	place/inanim
Norwegian	person	person
noses	object	object/plural
notables	person	person
notarius	person	person
notary	person	person
note	object	object/inanim
nothing	object	object/inanim
Nov.	time	time/inanim
novel	object	object/inanim
novelist	person	person
novelists	person	person
novelty	abstract	abstract/inanim
November	time	time-unit/inanim
now	time	time
number	quantity	quantity
numbers	quantity	quantity
numerologist	person	person
nun	person	person/female
nuncio	person	person
nurse	person	person
nursemaid	person	person/female
nutrients	substance	substance/plural
nutritionist	person	person
Oakland	place	place
Oakley	person	person
oath	abstract	abstract/inanim
object	object	object/inanim
objective	abstract	abstract/inanim
objective	abstract	abstract/inanim
Objects	object	object
objects	object	object/plural
oboist	person	person
observations	abstract	abstract
observer	person	person
obsession	abstract	abstract
obstetrician	person	person
obstructions	object	object/plural
occasions	event	event
ocean	place	place/inanim
oceanographer	person	person
ocelot	animal	animal
Oct.	time	time-unit/inanim
October	time	time-unit/inanim
octopus	animal	animal
odds	abstract	abstract/plural
odontologist	person	person
of	object	object
offense	abstract	abstract
offering	abstract	abstract/inanim
office	place	place/inanim
officer	person	person
officers	person	person/plural
officers	person	person/plural
offices	place	place/plural
official	person	person
officials	person	person/plural
offshore	place	place
ohio	object	object/inanim
Ohio	place	place
oil	substance	substance
oilpresser	person	person
oils	substance	substance
okapi	animal	animal
on	time	time
oncologist	person	person
one	abstract	abstract
One	object	object
one-liners	abstract	abstract
ones	object	object
onomastician	person	person
Onomatopoeia	abstract	abstract
onomatopoeia	abstract	abstract/inanim
onset	abstract	abstract/inanim
ontologist	person	person
opening	event	event
operation	event	event/inanim
operations	event	event/plural
operator	person	person
ophthalmologist	person	person
opinions	abstract	abstract/plural
opossum	animal	animal/inanim
opportunities	abstract	abstract
opportunity	abstract	abstract
opposite	person	person
optician	person	person
option	abstract	abstract/inanim
options	abstract	abstract
optometrist	person	person
oracle	person	person
orangutan	animal	animal
orator	person	person
orbiter	object	object
orbiters	object	object
Orchestra	organization	organization
orchestra	organization	organization/inanim
orchestrator	person	person
order	event	event/inanim
Oregon	place	place
organist	person	person
organization	abstract	abstract
Organization	organization	organization
organization	organization	organization/inanim
organizers	person	person
orientalist	person	person
origin	event	event/inanim
originality	abstract	abstract
ornithologist	person	person
orthodontist	person	person
orthopaedist	person	person
orthotist	person	person
oryx	animal	animal
osteichthyes	animal	animal
osteopath	person	person
ostrich	animal	animal
other	organization	organization
others	person	person
otolaryngologist	person	person
otorhinolaryngologist	person	person
otter	animal	animal
otterhound	animal	animal
our	person	person/plural
outbreak	event	event/inanim
outcome	event	event/inanim
outcrops	place	place/plural
outsider	person	person
outsiders	person	person/plural
oven	object	object
over	abstract	abstract
Overalls	object	object
overalls	object	object/plural
Overpass	object	object
owl	animal	animal
owner	person	person
owners	person	person
ox	animal	animal
oxygen	substance	substance/inanim
oyster	animal	animal
oz	quantity	quantity
ozone	substance	substance
Pacific	person	person
package	abstract	abstract/inanim
package	object	object/inanim
packer	person	person
Pad	place	place
pad	plant	plant/inanim
pads	plant	plant/plural
paella	substance	food/inanim
page	object	object/inanim
page-boy	person	person/male
pages	object	object
paint	substance	substance
painter	person	person
painting	event	event
pairs	plant	plant
Pakistani	person	person
palaeontologist	person	person
Palauan	person	person
paleoanthropologist	person	person
paleobiologist	person	person
paleoclimatologist	person	person
paleoethnobotanist	person	person
paleographer	person	person
paleontologist	person	person
Palestinian	person	person
pallbearer	person	person
pamphleteer	person	person
pan	object	object
Panamanian	person	person
pandanus	plant	plant
pandikona	animal	animal
panel	person	person
paniolo	person	person
panter	person	person
pantry	place	place
Pants	object	object
pants	object	object/plural
papa	person	person/male
paper	object	object
papers	object	object
paperwork	object	object
pappom	animal	animal
Papuan	person	person
papyrologist	person	person
parachute	organization	organization/inanim
parachutes	event	event/plural
Paraguayan	person	person
parakeet	animal	animal
paralegal	person	person
paralympian	person	person
Paralympics	event	event
paramedic	person	person
parameter	abstract	abstract/inanim
paraprofessional	person	person
parapsychologist	person	person
parasite	person	person
parasitologist	person	person
paratrooper	person	person
parent	person	person
parents	person	person/plural
park	event	event
Park	place	place
park	place	place/inanim
parking	event	event
parks	place	place
parliament	organization	organization
parliamentarian	person	person
parlor	place	place/inanim
parlormaid	person	person/female
parody	abstract	abstract/inanim
parole	event	event/inanim
parrot	animal	animal
parson	person	person
part	abstract	abstract
participants	person	person
parties	organization	organization
partisan	person	person
partisanship	abstract	abstract
partnership	abstract	abstract
partridge	animal	animal
parts	abstract	abstract
party	event	event/inanim
Party	organization	organization
passengers	person	person/plural
passerby	person	person
passerine	animal	animal
passing	event	event/inanim
passport	object	object/inanim
passports	object	object/plural
past	time	time
pasta	substance	food/inanim
pastor	person	person/male
pastoralist	person	person
path	abstract	abstract/inanim
pathologist	person	person
patience	abstract	abstract/inanim
patriarch	person	person/male
patron	person	person
patronage	person	person
patrons	person	person
pauses	abstract	abstract/plural
pawnbroker	person	person
paying	abstract	abstract
paymaster	person	person
payment	abstract	abstract/inanim
payoff	abstract	abstract/inanim
payroll	person	person
peace	abstract	abstract/inanim
peafowl	animal	animal
peanut	plant	plant
peat	substance	substance
pebbles	object	object/plural
peccary	animal	animal
peddler	person	person
pediatrician	person	person
pedodontist	person	person
pekingese	animal	animal
pelican	animal	animal
pen	object	object
penalty	abstract	abstract
penciller	person	person
penguin	animal	animal
penitentiary	place	place/inanim
penn	object	object
penologist	person	person
people	person	person
people	person	person/plural
people-smugglers	person	person
pepperer	person	person
percent	quantity	quantity
perception	abstract	abstract
percussionist	person	person
performance	event	event/inanim
performances	event	event
performer	person	person
perfumer	person	person
perfusionist	person	person
period	abstract	abstract
periodista	person	person
periodontist	person	person
Perkins	person	person
perlite	substance	substance
peroxide	substance	substance/inanim
person	person	person
personality	abstract	abstract
personnel	person	person/plural
Peruvian	person	person
pesto	object	object
pests	animal	animal
petiese	person	person
petition	abstract	abstract/inanim
petridishes	object	object/plural
petrologist	person	person
phailin	event	event/inanim
phalène	animal	animal
pharmacist	person	person
pharmacologist	person	person
phd	abstract	abstract/inanim
pheasant	animal	animal
phenomenon	abstract	abstract/inanim
philanthropist	person	person
philanthropists	person	person
philologist	person	person
philosopher	person	person
Phoenix	place	place
phone	object	object/inanim
phones	object	object
photo	object	object
photograph	object	object
photographer	person	person
photographers	person	person
photographs	object	object
photography	abstract	abstract
photojournalist	person	person
Photos	object	object
physician	person	person
physicist	person	person
physiologist	person	person
physiotherapist	person	person
pianist	person	person
pickler	person	person
picture	object	object
pictures	object	object
piece	object	object
pig	animal	animal
piled	abstract	abstract
pilgrams	person	person/plural
pilgrimage	event	event/inanim
pilgrims	person	person/plural
pillar	object	object/inanim
pills	object	object
pilot	person	person
pimp	person	person
pioneer	person	person
pipefitter	person	person
pirate	person	person
pitch	place	place/inanim
pitchman	person	person
pizzerias	place	place
place	place	place
places	place	place
plan	abstract	abstract
plane	object	object
Planetarium	place	place
planners	person	person/plural
planning	abstract	abstract
plant	place	place/inanim
plant	plant	plant
planter	person	person
Plants	place	place
plants	plant	plant
plantsman	person	person
plasterer	person	person
plastic	substance	substance
platypus	animal	animal
play	event	event
player	person	person
player-coach	person	person
players	person	person/plural
playoffs	event	event
playwright	person	person
Plaza	place	place
plaza	place	place/inanim
plazas	place	place/plural
plenary	event	event/inanim
plenty	place	place
pliers	object	tool
plot	abstract	abstract
plumber	person	person
plurals	abstract	abstract
pm	time	time
pocket	object	object
pockets	object	object
podcaster	person	person
podiatrist	person	person
poem	object	object
poems	object	object
poet	person	person
Poet	person	person
poetry	abstract	abstract/inanim
point	event	event
points	event	event/plural
Polaroid	object	object
Polaroids	object	object
pole	object	object/inanim
Pole	person	person
police	organization	organization
policeman	person	person
policy	abstract	abstract
politician	person	person
politicians	person	person/plural
politics	person	person/plural
politiker	person	person
poll	event	event
polling	event	event
polls	event	event
pollster	person	person
pollutants	object	object
pollution	substance	substance
polymath	person	person
polytheism	organization	organization
pomeranian	animal	animal
pony	animal	animal
poodle	animal	animal
pool	place	place/inanim
pope-elect	person	person/male
popularity	abstract	abstract
population	abstract	abstract
porcelaine	animal	animal
porcupine	animal	animal
porpoise	animal	animal
port	object	object/inanim
Port	place	place
porter	person	person
Portuguese	person	person
Poseidon	person	person
position	abstract	abstract/inanim
positions	abstract	abstract
possessions	object	object
possessions	object	object/plural
possibility	abstract	abstract/inanim
post	object	object
Post	organization	organization
post-season	event	event
postage	quantity	quantity/inanim
poster	person	person
posters	organization	organization
posting	object	object
postmaster	person	person
Posts	object	object
posts	place	place/plural
pot	place	place/inanim
potential	abstract	abstract
pots	person	person/plural
potter	person	person
poverty	abstract	abstract/inanim
powder	substance	substance
powder	substance	substance/inanim
power	abstract	abstract/inanim
powers	abstract	abstract/plural
practice	event	event/inanim
praise	abstract	abstract/inanim
prayer	abstract	abstract/inanim
preacher	person	person
precedents	abstract	abstract
precentor	person	person
predators	animal	animal/plural
prediction	abstract	abstract
prefect	person	person
preferences	abstract	abstract
prejudices	abstract	abstract/plural
prelate	person	person
premise	abstract	abstract/inanim
preparation	abstract	abstract/inanim
presence	abstract	abstract
present	abstract	abstract
present	object	object
presenter	person	person
presents	object	object
preservation	abstract	abstract
preservationist	person	person
preservatives	substance	substance
presidency	abstract	abstract/inanim
President	person	person
president	person	person
Press	object	object
press	organization	organization/inanim
pressure	abstract	abstract/inanim
pressure	abstract	abstract/inanim
Preston	place	place
pretext	abstract	abstract/inanim
prey	animal	animal/inanim
price	quantity	quantity/inanim
prices	quantity	quantity
pride	abstract	abstract
priest	person	person/male
Prieta	event	event
primate	animal	animal
primatologist	person	person
princess	animal	animal
printer	person	person
printmaker	person	person
prints	object	object
prior	person	person
prior	time	time
prison	place	place/inanim
private	organization	organization
probe	event	event/inanim
problem	abstract	abstract/inanim
problems	abstract	abstract
proceeds	abstract	abstract
process	abstract	abstract
proctologist	person	person
procyon	animal	animal
producer	person	person
product	object	object
product	person	person
production	abstract	abstract
products	abstract	abstract
professionals	person	person/plural
professor	person	person
professors	person	person/plural
program	abstract	abstract
programmer	person	person
progress	abstract	abstract/inanim
project	abstract	abstract
projectionist	person	person
projections	object	object
projects	abstract	abstract
prominence	abstract	abstract/inanim
promise	abstract	abstract/inanim
promoter	person	person
prompter	person	person
pronghorn	animal	animal
proof	abstract	abstract
proofreader	person	person
propaganda	abstract	abstract
property	object	object/inanim
prophet	person	person
proposal	abstract	abstract/inanim
proprietor	person	person
props	object	object
pros	person	person/plural
prosecution	event	event/inanim
prosecutor	person	person
prospect	abstract	abstract/inanim
prospector	person	person
prospectus	abstract	abstract/inanim
prosperity	abstract	abstract/inanim
prosthodontist	person	person
prostitute	person	person
protection	abstract	abstract
proteins	substance	substance
protopope	person	person/male
protostrator	person	person
providing	abstract	abstract
province	place	place/inanim
province	place	region/inanim
provinces	place	place/plural
provocation	place	place/inanim
psychiarist	person	person
psychiatrist	person	person
psychic	person	person
psychoanalyst	person	person
psycholinguist	person	person
psychologist	person	person
psychotherapist	person	person
public	organization	organization/inanim
publican	person	person
publication	event	event
publications	organization	organization/plural
publicist	person	person
publicity	abstract	abstract/inanim
publisher	person	person
publishers	person	person
pucker	abstract	abstract/inanim
pudelpointer	animal	animal
Puertorican	person	person
pug	animal	animal
puggle	animal	animal
puli	animal	animal
pulpit	object	object/inanim
pumi	animal	animal
pumice	substance	substance/inanim
punchline	abstract	abstract/inanim
punctuation	abstract	abstract
punishment	abstract	abstract/inanim
puppeteer	person	person
puppy	animal	animal
purchased	abstract	abstract/plural
puroresu	person	person
purple	abstract	abstract
purpose	abstract	abstract
put	event	event
pyncheon	animal	animal
pyrotechnician	person	person
Python	abstract	abstract/inanim
Q	place	place
quaffle	object	object/inanim
quagga	animal	animal
quail	animal	animal
qualifications	abstract	abstract/plural
quality	abstract	abstract
quality	person	person
Quantcast	organization	organization
quarter	quantity	quantity/inanim
quarter	time	time-unit/inanim
quartermaster	person	person
Quebecois	person	person
question	abstract	abstract
questions	abstract	abstract
quidditch	abstract	abstract/inanim
quidditch	abstract	abstract/plural
quiet	person	person
quilter	person	person
quivermaker	person	person
quote	abstract	abstract/inanim
Réunionian	person	person
rabbi	person	person
rabbit	animal	animal
raccoon	animal	animal
race	abstract	abstract/inanim
race	event	event/inanim
rack	object	object
Rack	person	person
racket	abstract	abstract
racketeering	person	person
raconteur	person	person
radio	organization	organization/inanim
radiobiochemist	person	person
radiographer	person	person
radiologist	person	person
raid	event	event/inanim
rail	object	object/inanim
rain	substance	substance/inanim
rainbow	object	object
rains	substance	substance/plural
rajapalayam	animal	animal
randlord	person	person
range	abstract	abstract
rank	abstract	abstract/inanim
rapper	person	person
rappers	person	person
rat	animal	animal
rat-catcher	person	person
rate	quantity	quantity/inanim
ratio	abstract	abstract
rationale	abstract	abstract/inanim
rave	event	event/inanim
raven	animal	animal
rays	object	object/plural
re-entry	event	event
reaches	place	place/plural
reaction	event	event/inanim
reactions	event	event/plural
readers	person	person
readers	person	person/plural
reading	abstract	abstract
readings	event	event
real-world	place	place
realistic	event	event/inanim
realities	abstract	abstract
Reality	abstract	abstract
reality	event	event/inanim
reason	abstract	abstract/inanim
reasons	abstract	abstract
Rebecca	person	person
rebel	person	person
rebuilding	event	event
receptionist	person	person
recession	event	event
recipe	object	object
recipient	person	person
recipients	organization	organization
reconstruction	place	place
record	abstract	abstract/inanim
record	object	object
recorder	person	person
recourse	abstract	abstract/inanim
recovery	event	event
recruiter	person	person
rector	person	person
red	abstract	abstract
reduction	abstract	abstract
reef	animal	animal/inanim
reefs	object	object
referee	person	person
references	person	person
referendum	event	event/inanim
referendums	quantity	quantity/plural
referent	person	person
reflection	event	event/inanim
reform	abstract	abstract
refrigerator	place	place
refund	abstract	abstract
refusals	event	event/plural
regent	person	person
region	place	place
registrar	person	person
regulation	abstract	abstract
regulations	abstract	abstract
reindeer	animal	animal
rejection	abstract	abstract
relations	abstract	abstract/plural
relatives	animal	animal
release	event	event/inanim
relic	object	object
religion	organization	organization
religions	organization	organization
reluctance	abstract	abstract/inanim
reminder	abstract	abstract/inanim
remixer	person	person
remodelling	event	event/inanim
remora	animal	animal
removal	event	event/inanim
renovation	event	event/inanim
rents	abstract	abstract
repairman	person	person/male
repetition	event	event/inanim
report	abstract	abstract/inanim
reporters	person	person
reports	abstract	abstract/plural
representative	person	person
reproduction	abstract	abstract
reptile	animal	animal
Repubblica	organization	organization
republic	place	place/inanim
Republican	person	person
Republicans	organization	organization
repudiation	abstract	abstract
request	event	event/inanim
requests	event	event
requests	event	event/plural
rescuer	person	person
research	abstract	abstract/inanim
researcher	person	person
researchers	person	person
researchers	person	person/plural
resident	person	person
residents	person	person
resistance	abstract	abstract/inanim
resource	abstract	abstract
resources	abstract	abstract
respect	abstract	abstract
response	abstract	abstract
responses	abstract	abstract/plural
responsibility	abstract	abstract/inanim
rest	abstract	abstract
restaurant	place	place
restaurants	place	place
restaurateur	person	person
restoration	abstract	abstract/inanim
restriction	abstract	abstract
result	abstract	abstract/inanim
results	abstract	abstract/plural
Results	object	object
retailer	person	person
retailers	place	place
retirement	event	event
retreat	event	event
return	event	event
revelation	abstract	abstract
revenue	object	object
reverand	person	person
review	event	event
revision	abstract	abstract/inanim
revival	event	event/inanim
revolution	abstract	abstract/inanim
Revolutionary	event	event
revolutionary	person	person
revolve	abstract	abstract
reward	abstract	abstract
rhetoric	abstract	abstract/inanim
rheumatologist	person	person
rhinoceros	animal	animal
Rhodes	person	person
rhythm	abstract	abstract/inanim
ribbon	object	object/inanim
Rican	person	person
rice	substance	food/inanim
riches	abstract	abstract
ride	abstract	abstract/inanim
ride	event	event/inanim
rigger	person	person
right	abstract	abstract
rights	abstract	abstract
ring	abstract	abstract/inanim
ring	object	object/inanim
ringmaster	person	person
rise	event	event
risk	abstract	abstract/inanim
rites	event	event/plural
rival	object	object
rivalries	abstract	abstract
river	place	place
riveter	person	person
road	place	place
roads	place	place/plural
roadshow	event	event/inanim
roadshows	event	event/plural
roadways	place	place
robber	person	person
roboticist	person	person
Rockridge	place	place
rocks	object	object
rodent	animal	animal
role	abstract	abstract
roll	abstract	abstract/inanim
rollerblader	person	person
Romanian	person	person
roofer	person	person
rook	animal	animal
room	object	object
rooms	place	place
roots	abstract	abstract
rope	object	object/inanim
ropemaker	person	person
ROS	substance	substance
ROS-concentration	quantity	quantity
rosewater	substance	substance
rot	event	event/inanim
ROTC	abstract	abstract
rotc	place	place/inanim
rottweiler	animal	animal
round	event	event/inanim
rounds	object	object/plural
route	abstract	abstract
route	place	place
routes	place	place/plural
rower	person	person
Rubell	person	person
ruins	object	object/plural
rule	abstract	abstract
rules	abstract	abstract
ruling	event	event
runemaster	person	person
runner	person	person
rush	abstract	abstract/inanim
Russian	person	person
Rwandan	person	person
ryeland	animal	animal
s	abstract	abstract
S&M	abstract	abstract
s&m	place	place/inanim
s/he	person	person
sacrifice	abstract	abstract
safari	abstract	abstract
safeguards	object	object/plural
safety	abstract	abstract/inanim
sagmatias	animal	animal
sailmaker	person	person
sailor	person	person
saint	person	person
salad	substance	food/inanim
salamander	animal	animal
salaryman	person	person/male
sale	event	event/inanim
salesman	person	person/male
salesperson	person	person
saleswoman	person	person/female
salonnieres	person	person
salons	place	place
saloon	place	place
salt	substance	substance
saluki	animal	animal
Salvadoran	person	person
sample	object	object
samples	object	object
samurai	person	person/male
sanction	abstract	abstract
sand	substance	substance/inanim
sandwich	object	food/inanim
santorum	object	object/inanim
sapsali	animal	animal
sarplaninac	animal	animal
Sarvis	person	person
satirist	person	person
Saturday	time	time-unit
Saturn	object	planet
saucier	person	person
Saudi	person	person
sawfiler	person	person
sawyer	person	person
saxophonist	person	person
scale	abstract	abstract/inanim
Scarne	object	object
scenario	event	event
scenarios	event	event
scene	abstract	abstract
scenographer	person	person
scent	abstract	abstract
schapendoes	animal	animal
schauspieler	person	person
schedules	abstract	abstract
schillerstövare	animal	animal
schipperke	animal	animal
schnoodle	animal	animal
scholar	person	person
scholar-official	person	person
school	organization	organization
school-related	place	place
schools	organization	organization/plural
science	abstract	abstract/inanim
scientist	person	person
scientists	person	person
scientists	person	person/plural
Scientology	organization	organization
scientology	organization	organization/inanim
scope	object	object
score	abstract	abstract/plural
scorpion	animal	animal
Scot	person	person
scout	person	person
screen	object	object
screenwriter	person	person
screw	object	object
screws	object	object
scribe	person	person
script	object	object/inanim
scrutiny	abstract	abstract/inanim
sculptor	person	person
Sea	place	place
sea	place	place/inanim
seabird	animal	animal
seaman	person	person/male
seamstress	person	person/female
searches	event	event/plural
season	event	event
season	time	time
seating	abstract	abstract/inanim
seats	object	object
Seattle	place	place
second	event	event
seconds	time	time
secretary	person	person
section	object	object
sections	plant	plant/plural
secularism	abstract	abstract/inanim
secularist	event	event/plural
security	abstract	abstract
see	abstract	abstract
seed	plant	plant
Seeds	plant	plant
seeds	plant	plant/plural
seeker	object	object/plural
seekers	person	person/plural
seekers	person	person/plural
seismologist	person	person
selection	abstract	abstract
selenographer	person	person
self-awareness	abstract	abstract
selfie	object	object
Senator	person	person
Senegalese	person	person
sensation	abstract	abstract/inanim
sense	abstract	abstract
sensei	person	person
sentence	object	object/inanim
Sep.	time	time-unit/inanim
September	time	time-unit/inanim
sequence	abstract	abstract
Serbian	person	person
sergigamez	person	person
series	abstract	abstract/inanim
server	object	object
server	object	object/inanim
server	person	person
service	abstract	abstract/inanim
Service	organization	organization
serviceman	person	person/male
services	abstract	abstract
serving	quantity	quantity
servings	abstract	abstract
set	abstract	abstract/inanim
sets	plant	plant
setting	abstract	abstract/inanim
setting	place	place/inanim
settlement	event	event/inanim
settlement	place	place/inanim
settlements	place	place/plural
settler	person	person
settlers	person	person/plural
setup	abstract	abstract/inanim
several	abstract	abstract
sex	event	event/inanim
sexton	person	person
shade	event	event/inanim
ShakataGaNai	person	person
sham	abstract	abstract
shaman	person	person
share	abstract	abstract
shark	animal	animal
Shea	place	place
sheep	animal	animal
sheet	object	object
shell	object	object/inanim
shells	object	object/plural
sheltered	place	place
sheltie	animal	animal
shepherd	person	person
sheriff	person	person
shield	object	object/inanim
shih-poo	animal	animal
shihainin	person	person
shihan	person	person
ship	place	place/inanim
ship-owner	person	person
shipping	abstract	abstract
ships	object	object/plural
shipwrecks	object	object/plural
shipwright	person	person
shirt	object	object
shirts	object	object
shochet	person	person
shock	abstract	abstract/inanim
shoemaker	person	person
shoes	object	object
shopkeeper	person	person
shopping	event	event
shops	place	place
shore	place	place
shores	place	place
shortfalls	abstract	abstract
Shorts	object	object
shorts	object	object/plural
shot	object	object
shots	object	object
shoulders	object	object
shove	abstract	abstract/inanim
show	abstract	abstract/inanim
show	event	event/inanim
showgirl	person	person/female
showman	person	person/male
showrunner	person	person
shrew	animal	animal
shuttle	object	object
shuttles	object	object
side	abstract	abstract
sideman	person	person
sides	object	object
siesta	event	event/inanim
sieve	object	object
sigger	person	person
sighthound	animal	animal
sights	place	place/plural
sign	abstract	abstract
signalman	person	person
signatures	object	object/plural
signing	event	event
signs	abstract	abstract/plural
signwriter	person	person
silversmith	person	person
Simmons	person	person
Simon	person	person
simplification	abstract	abstract
simply	event	event
Simpson	abstract	abstract
simulators	object	object
Sindhian	person	person
Singaporean	person	person
singer	person	person
singer-songwriter	person	person
sinologist	person	person
sins	abstract	abstract/plural
sisal	plant	plant/inanim
site	place	place
sites	place	place
situation	abstract	abstract/inanim
situations	abstract	abstract/plural
six	person	person
sixties	time	time
size	abstract	abstract
sizes	quantity	quantity
skateboarder	person	person
sketchbook	object	object/inanim
skewer	object	object
skier	person	person
skies	abstract	abstract/plural
skills	abstract	abstract
skin	object	object/inanim
Skinner	person	person
skirmish	event	event
skirmisher	person	person
skirts	object	object
Skittled	substance	substance
skittles	object	object
Skittles	object	object
skunk	animal	animal
skydivers	person	person/plural
skydiving	event	event/inanim
skyline	object	object
slater	person	person
slave	person	person
slavedriver	person	person
slavery	abstract	abstract/inanim
sleep	abstract	abstract/inanim
sleeves	object	object
slices	object	object
slides	object	object
slipstream	place	place/inanim
sloeber	animal	animal
sloth	animal	animal
sloughi	animal	animal
Slovak	person	person
Slovakian	person	person
Slovenian	person	person
smelter	person	person
smidge	quantity	quantity
smidgen	quantity	quantity
Smithsonian	place	place
smock	object	object/inanim
smog	substance	substance/inanim
smoker	person	person
smugness	abstract	abstract
snack	object	food/inanim
snacks	object	object
snail	animal	animal
snake	animal	animal
snipe	animal	animal
sniper	person	person
snippet	abstract	abstract
snippets	abstract	abstract/plural
snitch	person	person
snitches	object	object/plural
snow	substance	substance
snowboarder	person	person
SNY	organization	organization
So	event	event
soaper	person	person
socialism	abstract	abstract/inanim
socialite	person	person
society	abstract	abstract/inanim
sociologist	person	person
sock	object	object/inanim
soda	substance	substance
sodium	substance	substance/inanim
sofer	person	person
softener	object	object
software	abstract	abstract
soil	substance	substance
sold	event	event
soldier	person	person
solicitor	person	person
solution	abstract	abstract
solution	substance	substance
solutions	abstract	abstract/plural
Somali	person	person
some	abstract	abstract/plural
some	person	person/plural
some	plant	plant/plural
somebody	person	person
someone	person	person
Someone	person	person
something	object	object
sommelier	person	person
son	person	person/male
song	abstract	abstract/inanim
songwriter	person	person
sorcerer	person	person/male
sorghum	plant	plant
sorrows	abstract	abstract/plural
sort	abstract	abstract
sorts	organization	organization/plural
sotalia	animal	animal
soubrette	person	person
soul	abstract	abstract
sound	abstract	abstract
soundman	person	person/male
Soup	object	object
source	abstract	abstract/inanim
sourness	abstract	abstract
South	place	place
soybean	plant	plant
space	place	place
spaces	abstract	abstract
Spanish	person	person
sparrow	animal	animal
spartan	person	person
species	animal	animal
specimen	object	object
specimens	object	object
spectrophotometer	object	object/inanim
spectrum	abstract	abstract
speculator	person	person
speech	abstract	abstract/inanim
speech	event	event/inanim
speechwriter	person	person
speed	abstract	abstract/inanim
speeds	abstract	abstract
spelunker	person	person
spending	abstract	abstract
spice	object	object
spider	animal	animal
spinoff	object	object
spirit	abstract	abstract/inanim
Spitfire	event	event
splash	abstract	abstract
spokesman	person	person
spokesperson	person	person
spokeswoman	person	person/female
spores	object	object/plural
sport	abstract	abstract/inanim
sports	abstract	abstract
sports	abstract	abstract/plural
spot	place	place/inanim
spots	place	place/plural
spread	abstract	abstract/inanim
spring	time	time-unit/inanim
springbok	animal	animal
Springs	place	place
sprouts	plant	plant
spy	person	person
spymaster	person	person
Square	place	place
square	place	place/inanim
squares	place	place/plural
squid	animal	animal
squirrel	animal	animal
St.	place	place
stabyhoun	animal	animal
Stadium	place	place
staff	person	person
stagehand	person	person
staircase	place	place/inanim
stalk	plant	plant
stalker	person	person
stallion	animal	animal
stamp	object	object/inanim
stampede	event	event/inanim
stampedes	event	event/plural
stand	abstract	abstract
stand-in	person	person
standard	abstract	abstract/inanim
stanza	object	object
star	object	object
star	person	person
stars	person	person
start	event	event
State	place	place
state	place	place/inanim
statement	abstract	abstract
statements	abstract	abstract/plural
states	person	person/plural
States	place	place
statesman	person	person/male
Station	place	place
station	place	place/inanim
stations	place	place
statistician	person	person
statistics	abstract	abstract/plural
statue	object	object/inanim
status	abstract	abstract
stays	event	event/plural
steelworker	person	person
steersman	person	person/male
Stein	person	person
stem	plant	plant
stems	plant	plant
stenella	animal	animal
stenographer	person	person
step	event	event
steps	abstract	abstract
stereographer	person	person
stevedore	person	person
steward	person	person
stick	object	object/inanim
sticks	object	object/plural
stints	event	event/plural
stipulation	abstract	abstract
stockbroker	person	person
stockholder	person	person
stockman	person	person/male
stone	object	object/inanim
stone	substance	substance/inanim
stonecutter	person	person
stonemason	person	person
Store	place	place
store	place	place/inanim
storefronts	place	place
storekeeper	person	person
stores	place	place
storm	event	event/inanim
storms	event	event/plural
story	abstract	abstract/inanim
story-teller	person	person
strainer	object	object
stranger	person	person
strangers	person	person/plural
strap	object	object/inanim
straps	object	object
strategies	abstract	abstract/plural
strategist	person	person
strategy	abstract	abstract/inanim
strawberry	substance	substance
Streep	person	person
street	place	place
streets	place	place
strength	object	object/inanim
stress	abstract	abstract/inanim
string	abstract	abstract
string	object	object
strings	abstract	abstract
stripper	person	person
strongman	person	person/male
strongwoman	person	person/female
structure	abstract	abstract
structures	abstract	abstract
STS-1	event	event
STS-133	event	event
STS-134	event	event
STS-135	event	event
student	person	person
students	person	person/plural
studied	abstract	abstract
studies	event	event
Studio	organization	organization
studio	place	place
study	event	event
stuff	object	object
stumps	person	person/plural
style	abstract	abstract
stylist	person	person
styrmann	person	person
sub-inspector	person	person
subjects	animal	animal/plural
substances	substance	substance/plural
suburb	place	place/inanim
success	abstract	abstract
successes	abstract	abstract
Sudanese	person	person
suffix	abstract	abstract
sugar	substance	substance
suggestions	abstract	abstract/plural
suicide	event	event/inanim
suit	abstract	abstract/inanim
suit	object	object/inanim
sum	quantity	quantity/inanim
summer	time	time-unit/inanim
summit	event	event/inanim
sun	object	object/inanim
sunbathing	event	event
sunlight	substance	substance
sunny	abstract	abstract
sunshine	substance	substance
superintendent	person	person
superiors	person	person
supermarkets	place	place
supermodel	person	person/female
superstores	place	place
supervision	abstract	abstract/inanim
supplies	abstract	abstract
supply	abstract	abstract
support	abstract	abstract/inanim
supporters	person	person/plural
surface	place	place/inanim
surfer	person	person
surgeon	person	person
Surinamese	person	person
surprise	place	place/inanim
surveillance	person	person
survey	abstract	abstract/inanim
surveyor	person	person
survival	event	event/inanim
swallow	animal	animal
swan	animal	animal
Swedish	person	person
sweeper	person	person
swimmer	person	person
swineherd	person	person
swordsmith	person	person
symposium	event	event/inanim
synthesist	person	person
Syriac	person	person
Syrian	person	person
syrup	object	object
sysop	person	person
system	abstract	abstract
t-shirts	object	object
table	object	object
tables	object	object
tactician	person	person
tag	abstract	abstract
taigan	animal	animal
tail	object	object/inanim
tailor	person	person
Taiwanese	person	person
Taking	event	event
talk	event	event
talks	event	event/plural
Tan	person	person
tanager	animal	animal
tanner	person	person
Tanzanian	person	person
TAOM	event	event
tape	object	object
tapir	animal	animal
tarento	person	person
target	abstract	abstract/inanim
taste	abstract	abstract
Tax	abstract	abstract
tax	abstract	abstract/inanim
taxes	abstract	abstract/plural
taxi	object	car/inanim
taxidermist	person	person
taxonomist	person	person
te	place	place/inanim
tea	substance	substance
teacher	person	person
teachers	person	person/plural
team	organization	organization
teams	organization	organization
teamster	person	person
tears	substance	substance
teaspoons	substance	substance
technician	person	person
technique	abstract	abstract
techniques	abstract	abstract/plural
technologist	person	person
technology	abstract	abstract
teenager	person	person
telegram	object	object
telegraphist	person	person
televangelist	person	person
television	abstract	abstract/inanim
telomian	animal	animal
Temescal	place	place
temperature	substance	substance
temperatures	abstract	abstract
temple	place	place
temples	object	object
temptations	abstract	abstract
ten	quantity	quantity
tendency	abstract	abstract/inanim
tendrils	plant	plant
Tennessee	place	place
tennis	person	person
tension	abstract	abstract/inanim
tentmaker	person	person
tenure	abstract	abstract
term	abstract	abstract
Terrace	place	place
terror	abstract	abstract
terrorism	abstract	abstract
terrorist	person	person
terrorists	person	person/plural
tervuren	animal	animal
test	abstract	abstract
tester	person	person
Teterboro	place	place
Texans	person	person
Texas	place	place
Thai	person	person
Thailand	place	place
Thais	person	person
Thank	event	event
That	abstract	abstract
that	abstract	abstract/inanim
thatcher	person	person
Theater	place	place
theaters	place	place
theatre	place	place
theft	abstract	abstract
theft	event	event
their	abstract	abstract/plural
them	object	object/plural
then	event	event
theologian	person	person
theoretician	person	person
theory	abstract	abstract/inanim
there	place	place/inanim
they	place	place/plural
thief	person	person
thimbler	person	person
thing	abstract	abstract
things	abstract	abstract
things	object	object/plural
think	person	person
this	abstract	abstract/plural
Thompson	person	person
thoroughbred	animal	animal
thought	abstract	abstract
thoughts	abstract	abstract/plural
thousands	person	person
threat	abstract	abstract
throughout	time	time
thunderstorms	abstract	abstract
Thursday	time	time-unit
Tibetan	person	person
ties	object	object
tiger	animal	animal
tiles	abstract	abstract
time	time	time-unit
Times	organization	organization
times	time	time-unit/plural
Timorese	person	person
timpanist	person	person
tinker	person	person
tinner	person	person
tinsmith	person	person
tip	place	place/inanim
tips	abstract	abstract/plural
tires	object	object
title	abstract	abstract
to	abstract	abstract/inanim
toad	animal	animal
tobacconist	person	person
Tobagonian	person	person
today	time	time-unit
toiletries	object	object
Tom	person	person
Tongatapu	place	place
tontechniker	person	person
tool	object	object
toolmaker	person	person
tools	object	object
top	place	place/inanim
topic	abstract	abstract/inanim
topics	abstract	abstract
toponymist	person	person
tops	object	object
torero	person	person
tornjak	animal	animal
torrent	abstract	abstract
torrent	quantity	quantity
torturer	person	person
tosa	animal	animal
toshiyori	person	person
touches	person	person
touchstones	person	person
tour	event	event/inanim
tourism	person	person
tourist	person	person
tourists	person	person/plural
Tournament	event	event
tournament	event	event/inanim
towels	object	object
tower	place	place/inanim
town	place	place
toxicologist	person	person
track	person	person
trade	abstract	abstract
trader	person	person
tradesman	person	person
tradition	abstract	abstract/inanim
traditions	abstract	abstract/plural
Traffic	abstract	abstract
traffic	abstract	abstract/inanim
trails	place	place
trainer	object	object
trainer	person	person
trakehner	animal	animal
trams	object	object/plural
transaction	event	event/inanim
transfer	abstract	abstract
transfer	event	event
transit	organization	organization
transition	event	event
translator	person	person
transport	event	event/inanim
transportation	abstract	abstract
trapper	person	person
trash	place	place/inanim
travel	abstract	abstract
traveler	person	person
travelers	person	person/plural
traveller	person	person
travellers	person	person/plural
tray	object	object
treasure	object	object/inanim
treasures	object	object
treatment	abstract	abstract/inanim
treatment	event	event/inanim
tree	plant	plant
trees	object	object
triathlete	person	person
tribe	person	person
tribes	organization	organization/plural
tribologist	person	person
trichology	person	person
trick	abstract	abstract/inanim
tricks	abstract	abstract
Trinidadian	person	person
trip	event	event
trips	event	event
trombonist	person	person
troops	person	person/plural
truly	abstract	abstract/plural
trumpeter	person	person
truth	abstract	abstract/inanim
tube	object	object/inanim
tubes	object	object/plural
tucuxi	animal	animal
Tuesday	time	time-unit
tulku	person	person
Tunisian	person	person
tunnel	object	object/inanim
turismo@merida.gob.mx	abstract	abstract/inanim
Turk	person	person
turkey	animal	animal
turmoil	abstract	abstract
turn	abstract	abstract/inanim
turner	person	person
turntablist	person	person
turtle	animal	animal
tutor	person	person
Tuvaluan	person	person
twenties	time	time/plural
twines	object	object/plural
Twitter	abstract	abstract/inanim
Twitter	organization	organization
two	abstract	abstract
two-party	organization	organization
type	abstract	abstract/inanim
typefounder	person	person
types	place	place
typesetting	person	person
tyrant	person	person
T\'ho	place	place
U-haul	organization	organization
U.S.	place	place
UAAR	organization	organization
uda	animal	animal
ufologist	person	person
ufology	person	person
Ugandan	person	person
UK	place	place
Ukrainian	person	person
ulama	person	person
umpire	person	person
uncertainty	abstract	abstract
uncle	person	person/male
under	abstract	abstract
Underground	organization	organization
undernourishment	abstract	abstract
undersecretary	person	person
understanding	abstract	abstract
union	organization	organization
unit	object	object/inanim
units	organization	organization/plural
universities	organization	organization
university	organization	organization
university	place	place
unknowns	person	person
unrest	abstract	abstract/inanim
unused	object	object
update	event	event/inanim
upholsterer	person	person
Uptown	place	place
uptown	place	place/inanim
urbanization	event	event/inanim
urge	abstract	abstract
urologist	person	person
ursari	person	person
Uruguayan	person	person
US	place	place
USA	place	place
USD	quantity	quantity/plural
use	abstract	abstract
used	event	event
user	person	person
username	abstract	abstract/inanim
users	person	person
usher	person	person
USI	organization	organization
Using	event	event
usurper	person	person
utensil	object	object/inanim
utonagan	animal	animal
Uzbek	person	person
valet	person	person
valley	place	place/inanim
value	abstract	abstract
values	abstract	abstract/plural
vanilla	substance	substance
vans	object	object/plural
Vanuatuan	person	person
variant	object	object/inanim
variation	person	person/plural
varieties	abstract	abstract
Vava’u	place	place
Vava\'u	place	place
vedette	person	person
Vegas	place	place
vegetation	plant	plant
vehicle	object	object/inanim
vehicles	object	object/plural
veins	plant	plant
velocity	abstract	abstract/inanim
vendor	person	person
vendors	person	person
Venezuelan	person	person
ventriloquist	person	person
venture	abstract	abstract/inanim
veranda	place	place/inanim
verdict	abstract	abstract/inanim
vermiculite	substance	substance
verse	abstract	abstract/inanim
version	abstract	abstract/inanim
versions	abstract	abstract
vertebrate	animal	animal
vessel	object	object/inanim
vessels	object	object/plural
veteran	person	person
vibe	abstract	abstract
vibraphonist	person	person
victims	person	person/plural
Victory	object	object
vicuña	animal	animal
video	object	object
videographer	person	person
videos	object	object/plural
Vietnamese	person	person
views	abstract	abstract
viking	person	person
village	place	place
villages	place	place/plural
vinegar	substance	substance
violinist	person	person
violinmaker	person	person
violist	person	person
viperidae	animal	animal
Virginia	place	place
virologist	person	person
virtuoso	person	person
visa	organization	organization/inanim
VisaCuba	organization	organization
vision	abstract	abstract
visionary	person	person
visit	event	event/inanim
visitor	person	person
Visitors	person	person
visitors	person	person/plural
visits	abstract	abstract
viverridae	animal	animal
vizsla	animal	animal
vj	person	person
vlogger	person	person
vodka	substance	substance
Vogel	abstract	abstract
Vogelaviatiolap	abstract	abstract
Vogelaviatiolaps	abstract	abstract
Voice	object	object
volcanologist	person	person
volleyball	object	object/inanim
volunteer	person	person
volunteers	person	person
Vostok	object	object
vote	abstract	abstract/inanim
Voters	person	person
voters	person	person/plural
vouchers	object	object
vowel	object	object
vowels	abstract	abstract
vulnerabilities	abstract	abstract
vulture	animal	animal
wagonmaker	person	person
wai	event	event
waiing	event	event
wakeboarder	person	person
walk	event	event
walking	event	event
walks	event	event
wall	object	object
Walmart	organization	organization
walrus	animal	animal
want	abstract	abstract
war	event	event
warehouseman	person	person/male
warehouses	place	place
Warhol	person	person
warlord	person	person
warming	event	event
warplanes	object	object/plural
warrior	person	person
wars	event	event/plural
warship	object	object/inanim
wash	abstract	abstract
washboard	object	object
Washington	person	person
waste	substance	substance/inanim
watchmaker	person	person
watchman	person	person/male
Water	person	person
water	substance	substance
waterbuck	animal	animal
Waters	person	person
waters	place	place/plural
wats	place	place
wave	person	person
way	abstract	abstract
ways	abstract	abstract/plural
wealth	abstract	abstract
wealthy	person	person/plural
weapon-smith	person	person
wear	abstract	abstract
wearing	abstract	abstract
weasel	animal	animal
weathercaster	person	person
weaver	person	person
web	abstract	abstract
webmaster	person	person
website	place	place
websites	place	place/plural
Weehawken	place	place
week	time	time-unit/inanim
weekend	time	time
weeks	time	time-unit/plural
weight	place	place/inanim
weightlifter	person	person
weimaraner	animal	animal
welder	person	person
Welsh	person	person
west	place	place
Westerners	person	person
wetterhoun	animal	animal
whale	animal	animal
whales	animal	animal
What	abstract	abstract
what	object	object
wheat	plant	plant
wheelwright	person	person
while	time	time/inanim
whippet	animal	animal
whistleblower	person	person
whitesmith	person	person
Whitman	person	person
wholphin	animal	animal
Wicca	organization	organization
widget	abstract	abstract/inanim
wife	person	person/female
wig	object	object
Wiki	object	object
wikiHow	place	place
wikiLove	abstract	abstract
wikilove	abstract	abstract/inanim
Wikinews	organization	organization
Wikipedia	organization	organization
wild	place	place/inanim
wildcat	animal	animal
wildcatter	person	person
wildebeest	animal	animal
wildlife	animal	animal/inanim
Wilkins	person	person
willow	animal	animal
willpower	abstract	abstract/inanim
window	object	object
winds	place	place
winemaker	person	person
wing	abstract	abstract/inanim
Winning	event	event
winston	animal	animal
winter	time	time-unit/inanim
wisdom	abstract	abstract/inanim
within	organization	organization/plural
wives	person	person/plural
wolf	animal	animal
wolverine	animal	animal
wolves	animal	animal
woman	person	person/female
wombat	animal	animal
Women	person	person
women	person	person/plural
wonder	abstract	abstract
wonderworker	person	person
woodcutter	person	person
woodsman	person	person/male
woodturner	person	person
woodworker	person	person
wooler	person	person
word	abstract	abstract
words	abstract	abstract
work	abstract	abstract
worker	person	person
workers	animal	animal/plural
workman	person	person/male
works	object	object
world	place	place
worldview	abstract	abstract
worm	animal	animal
worship	abstract	abstract
worshippers	person	person
worth	object	object
wrangler	person	person
wrap	object	object
wren	animal	animal
wrestler	person	person
writer	person	person
writing	event	event/inanim
writings	abstract	abstract/plural
WWII	event	event
www.flag.govt.nz	place	place
www.standfor.co.nz	place	place
Xinhua	organization	newspaper/inanim
xnewspaper	object	object
XP	object	object
xylophonist	person	person
Y-tong	substance	substance
yachties	object	object
yachts	object	object
yak	animal	animal
yard	place	place
year	time	time-unit/inanim
years	time	time-unit/plural
Yemeni	person	person
yeoman	person	person/male
yesterday	time	time-unit/inanim
yield	object	object
yields	object	object/plural
yodeler	person	person
York	place	place
young	person	person
YouTube	organization	organization
youtuber	person	person
yoyobichi	person	person
yuppie	person	person
yuppy	person	person
Zambian	person	person
zamindar	person	person
Zealand	person	person
zebu	animal	animal
Zeitgeist	abstract	abstract
zeitgeist	abstract	abstract/inanim
Zeus	person	person
Zimbabwean	person	person
zombie	person	person
zone	place	place/inanim
zookeeper	person	person
zoologist	person	person
\$	quantity	quantity/inanim
\'scopes	object	object/plural